customer_id,recency,frequency,monetary,R_score,F_score,M_score,RFM_sum
12346.0,610.0,17,-64.67999999999302,1,4,1,6
12347.0,96.0,8,5633.32,3,3,4,10
12348.0,221.0,5,2019.4,2,3,3,8
12349.0,973.0,5,4404.54,1,3,4,8
12350.0,312.0,1,334.4,2,1,2,5
12351.0,0.0,1,300.93,4,1,1,6
12352.0,275.0,13,1889.21,2,4,3,9
12353.0,0.0,2,406.76,4,1,2,7
12354.0,0.0,1,1079.4,4,1,3,8
12355.0,97.0,2,947.61,3,1,3,7
12356.0,129.0,6,6373.68,2,3,4,9
12357.0,183.0,3,18287.66,2,2,4,8
12358.0,4.0,5,3887.07,3,3,4,10
12359.0,10.0,14,8714.89,3,4,4,11
12360.0,365.0,9,4212.89,2,4,4,10
12361.0,462.0,4,511.25,1,2,2,5
12362.0,31.0,14,5284.58,3,4,4,11
12363.0,37.0,2,552.0,3,1,2,6
12364.0,302.0,4,1313.1,2,2,3,7
12365.0,0.0,3,320.69,4,2,1,7
12366.0,0.0,1,500.24,4,1,2,7
12367.0,213.0,1,168.9,2,1,1,4
12368.0,0.0,1,917.6999999999999,4,1,3,8
12369.0,495.0,3,1791.15,1,2,3,6
12370.0,69.0,7,4320.31,3,3,4,10
12371.0,31.0,5,4067.38,3,3,4,10
12372.0,36.0,3,1298.04,3,2,3,8
12373.0,343.0,3,1127.65,2,2,3,7
12374.0,0.0,4,2989.2200000000003,4,2,4,10
12375.0,152.0,3,455.42,2,2,2,6
12376.0,0.0,2,503.15,4,1,2,7
12377.0,0.0,4,3426.32,4,2,4,10
12378.0,306.0,2,5416.32,2,1,4,7
12379.0,157.0,5,1618.27,2,3,3,8
12380.0,158.0,15,7888.0,2,4,4,10
12381.0,1.0,6,1803.96,3,3,3,9
12382.0,0.0,1,-18.38,4,1,1,6
12383.0,10.0,6,1839.31,3,3,3,9
12384.0,30.0,3,566.16,3,2,2,7
12385.0,0.0,2,1923.4,4,1,3,8
12386.0,193.0,2,660.8,2,1,2,5
12387.0,0.0,1,143.94,4,1,1,6
12388.0,99.0,8,3901.11,3,3,4,10
12389.0,668.0,3,1433.33,1,2,3,6
12390.0,0.0,1,549.84,4,1,2,7
12391.0,617.0,7,2747.82,1,3,4,8
12392.0,0.0,1,234.75000000000003,4,1,1,6
12393.0,40.0,7,2376.75,3,3,4,10
12394.0,154.0,2,1272.48,2,1,3,6
12395.0,6.0,18,5046.92,3,4,4,11
12396.0,649.0,1,931.43,1,1,3,5
12397.0,244.0,2,2409.9,2,1,4,7
12398.0,0.0,1,1635.6599999999999,4,1,3,8
12399.0,3.0,7,1962.3,3,3,3,9
12400.0,0.0,1,205.25,4,1,1,6
12401.0,100.0,1,84.3,3,1,1,5
12402.0,365.0,7,1244.15,2,3,3,8
12403.0,552.0,3,1001.36,1,2,3,6
12404.0,0.0,1,63.24,4,1,1,6
12405.0,0.0,1,1710.39,4,1,3,8
12406.0,94.0,7,6072.21,3,3,4,10
12407.0,187.0,5,1708.1200000000001,2,3,3,8
12408.0,129.0,14,4279.64,2,4,4,10
12409.0,66.0,13,23090.47,3,4,4,11
12410.0,39.0,4,1001.46,3,2,3,8
12411.0,0.0,1,346.9,4,1,2,7
12412.0,459.0,8,2581.03,1,3,4,8
12413.0,10.0,6,935.5,3,3,3,9
12414.0,189.0,8,692.41,2,3,2,7
12415.0,71.0,33,143269.29,3,4,4,11
12416.0,0.0,1,202.56,4,1,1,6
12417.0,61.0,27,6708.21,3,4,4,11
12418.0,371.0,5,2016.95,1,3,3,7
12419.0,0.0,2,503.01,4,1,2,7
12420.0,154.0,1,600.39,2,1,2,5
12421.0,0.0,8,1092.83,4,3,3,10
12422.0,216.0,21,4119.35,2,4,4,10
12423.0,90.0,11,2612.19,3,4,4,11
12424.0,461.0,7,3289.78,1,3,4,8
12425.0,580.0,3,1680.81,1,2,3,6
12426.0,648.0,3,1311.41,1,2,3,6
12427.0,62.0,5,1011.87,3,3,3,9
12428.0,33.0,12,7877.2,3,4,4,11
12429.0,400.0,9,7435.51,1,4,4,9
12430.0,0.0,1,256.4,4,1,1,6
12431.0,3.0,33,10719.41,3,4,4,11
12432.0,0.0,5,5059.32,4,3,4,11
12433.0,90.0,11,20428.86,3,4,4,11
12434.0,251.0,5,1062.48,2,3,3,8
12435.0,373.0,6,13925.93,1,3,4,8
12436.0,336.0,1,509.01,2,1,2,5
12437.0,10.0,47,12394.85,3,4,4,11
12438.0,0.0,2,2906.85,4,1,4,9
12439.0,0.0,3,1104.48,4,2,3,9
12440.0,489.0,3,768.15,1,2,2,5
12441.0,486.0,1,347.1,1,1,2,4
12442.0,182.0,1,172.06,2,1,1,4
12443.0,882.0,1,485.31,1,1,2,4
12444.0,1.0,5,5005.46,3,3,4,10
12445.0,608.0,3,426.48,1,2,2,5
12446.0,0.0,1,1002.3100000000001,4,1,3,8
12447.0,68.0,1,476.49,3,1,2,6
12448.0,0.0,1,449.45,4,1,2,7
12449.0,93.0,6,4835.89,3,3,4,10
12450.0,187.0,7,666.95,2,3,2,7
12451.0,215.0,10,12546.53,2,4,4,10
12452.0,0.0,3,428.57,4,2,2,8
12453.0,0.0,1,707.09,4,1,2,7
12454.0,456.0,9,4292.71,1,4,4,9
12455.0,187.0,10,5879.95,2,4,4,10
12456.0,0.0,4,3153.89,4,2,4,10
12457.0,1.0,14,2472.31,3,4,4,11
12458.0,459.0,4,1777.49,1,2,3,6
12459.0,0.0,1,454.36,4,1,2,7
12460.0,458.0,1,326.65,1,1,2,4
12461.0,126.0,2,826.88,2,1,2,5
12462.0,100.0,4,1124.01,3,2,3,8
12463.0,7.0,7,1303.63,3,3,3,9
12464.0,284.0,8,1212.05,2,3,3,8
12465.0,302.0,3,733.89,2,2,2,6
12466.0,0.0,1,56.73,4,1,1,6
12467.0,366.0,2,0.0,1,1,1,3
12468.0,219.0,10,3624.55,2,4,4,10
12469.0,583.0,2,3070.54,1,1,4,6
12470.0,0.0,1,211.95,4,1,1,6
12471.0,1.0,129,37948.61,3,4,4,11
12472.0,91.0,37,16956.69,3,4,4,11
12473.0,61.0,9,2848.23,3,4,4,11
12474.0,4.0,54,11966.45,3,4,4,11
12475.0,0.0,2,1149.64,4,1,3,8
12476.0,121.0,38,13715.62,2,4,4,10
12477.0,39.0,12,20173.64,3,4,4,11
12478.0,182.0,1,680.99,2,1,2,5
12479.0,182.0,3,477.3,2,2,2,6
12480.0,30.0,8,5435.1,3,3,4,10
12481.0,163.0,18,12217.03,2,4,4,10
12482.0,371.0,32,21893.53,1,4,4,9
12483.0,36.0,27,4846.87,3,4,4,11
12484.0,153.0,16,6303.85,2,4,4,10
12485.0,0.0,1,708.1,4,1,2,7
12486.0,610.0,1,1037.28,1,1,3,5
12487.0,820.0,2,259.79999999999995,1,1,1,3
12488.0,0.0,3,1298.66,4,2,3,9
12489.0,163.0,1,334.93,2,1,2,5
12490.0,97.0,22,9818.64,3,4,4,11
12491.0,334.0,1,460.40000000000003,2,1,2,5
12492.0,154.0,3,715.21,2,2,2,6
12493.0,0.0,3,416.79,4,2,2,8
12494.0,218.0,17,1743.52,2,4,3,9
12495.0,464.0,2,323.4,1,1,1,3
12496.0,0.0,2,54.09,4,1,1,6
12497.0,587.0,4,6211.75,1,2,4,7
12498.0,0.0,3,403.70000000000005,4,2,2,8
12499.0,0.0,1,393.72,4,1,2,7
12500.0,71.0,25,5872.31,3,4,4,11
12501.0,163.0,2,2089.68,2,1,3,6
12502.0,189.0,5,3723.87,2,3,4,9
12503.0,193.0,2,0.0,2,1,1,4
12504.0,91.0,6,411.0,3,3,2,8
12505.0,39.0,3,908.0,3,2,3,8
12506.0,0.0,1,73.5,4,1,1,6
12507.0,157.0,5,1797.31,2,3,3,8
12508.0,61.0,2,398.27,3,1,2,6
12509.0,0.0,1,176.5,4,1,1,6
12510.0,405.0,16,3689.33,1,4,4,9
12511.0,519.0,2,3065.77,1,1,4,6
12512.0,245.0,2,138.03,2,1,1,4
12513.0,0.0,2,586.79,4,1,2,7
12514.0,495.0,2,1597.76,1,1,3,5
12515.0,0.0,1,383.7,4,1,2,7
12516.0,5.0,4,2648.62,3,2,4,9
12517.0,30.0,6,2464.89,3,3,4,10
12518.0,1.0,5,2056.89,3,3,3,9
12519.0,154.0,3,695.19,2,2,2,6
12520.0,38.0,6,2582.51,3,3,4,10
12521.0,0.0,1,599.68,4,1,2,7
12522.0,0.0,2,192.72,4,1,1,6
12523.0,10.0,30,4220.85,3,4,4,11
12524.0,71.0,18,11091.36,3,4,4,11
12525.0,431.0,8,835.1800000000001,1,3,2,6
12526.0,90.0,3,1316.66,3,2,3,8
12527.0,671.0,5,735.51,1,3,2,6
12528.0,130.0,8,1922.28,2,3,3,8
12529.0,583.0,2,311.78000000000003,1,1,1,3
12530.0,31.0,12,3689.86,3,4,4,11
12531.0,0.0,3,1899.05,4,2,3,9
12532.0,91.0,1,349.83000000000004,3,1,2,6
12533.0,405.0,6,1149.99,1,3,3,7
12534.0,337.0,1,1089.18,2,1,3,6
12535.0,93.0,2,716.35,3,1,2,6
12536.0,31.0,5,4106.82,3,3,4,10
12537.0,0.0,1,732.94,4,1,2,7
12538.0,61.0,2,640.45,3,1,2,6
12539.0,71.0,8,9498.9,3,3,4,10
12540.0,40.0,36,22107.29,3,4,4,11
12541.0,61.0,3,981.18,3,2,3,8
12542.0,367.0,4,423.38,1,2,2,5
12543.0,0.0,1,980.25,4,1,3,8
12544.0,61.0,2,355.7,3,1,2,6
12545.0,0.0,2,1000.39,4,1,3,8
12546.0,245.0,3,1141.5,2,2,3,7
12547.0,252.0,3,383.58,2,2,2,6
12548.0,0.0,1,95.19999999999999,4,1,1,6
12549.0,375.0,6,1575.68,1,3,3,7
12550.0,0.0,1,964.83,4,1,3,8
12551.0,0.0,1,168.0,4,1,1,6
12552.0,334.0,2,437.82,2,1,2,5
12553.0,1.0,17,4548.82,3,4,4,11
12554.0,0.0,1,468.5,4,1,2,7
12555.0,0.0,1,129.23,4,1,1,6
12556.0,34.0,2,603.71,3,1,2,6
12557.0,40.0,8,18716.14,3,3,4,10
12558.0,121.0,2,1.0658141036401503e-14,2,1,1,4
12559.0,312.0,3,536.21,2,2,2,6
12560.0,243.0,4,2101.39,2,2,3,7
12561.0,70.0,1,238.85,3,1,1,5
12562.0,217.0,9,4966.92,2,4,4,10
12563.0,0.0,1,249.24,4,1,1,6
12564.0,0.0,1,456.9,4,1,2,7
12565.0,283.0,2,131.17,2,1,1,4
12566.0,0.0,2,346.7,4,1,2,7
12567.0,127.0,17,13393.82,2,4,4,10
12568.0,587.0,1,70.0,1,1,1,3
12569.0,1.0,35,4064.9900000000002,3,4,4,11
12570.0,0.0,1,77.52,4,1,1,6
12571.0,64.0,2,519.61,3,1,2,6
12572.0,333.0,3,1004.72,2,2,3,7
12573.0,396.0,5,717.41,1,3,2,6
12574.0,0.0,1,218.45,4,1,1,6
12575.0,489.0,2,622.8199999999999,1,1,2,4
12576.0,131.0,11,2083.87,2,4,3,9
12577.0,244.0,9,1591.35,2,4,3,9
12578.0,224.0,7,4572.45,2,3,4,9
12579.0,0.0,3,410.72,4,2,2,8
12580.0,160.0,2,1052.9,2,1,3,6
12581.0,0.0,1,197.71,4,1,1,6
12582.0,401.0,4,1980.4,1,2,3,6
12583.0,1.0,31,14344.9,3,4,4,11
12584.0,158.0,18,1893.95,2,4,3,9
12585.0,224.0,4,1982.81,2,2,3,7
12586.0,547.0,5,2028.67,1,3,3,7
12587.0,302.0,1,144.0,2,1,1,4
12588.0,579.0,5,938.98,1,3,3,7
12589.0,30.0,11,3094.17,3,4,4,11
12590.0,6.0,5,9853.48,3,3,4,10
12591.0,0.0,3,1352.15,4,2,3,9
12592.0,67.0,8,1152.62,3,3,3,9
12593.0,220.0,3,418.09999999999997,2,2,2,6
12594.0,64.0,17,5044.51,3,4,4,11
12595.0,0.0,1,299.02,4,1,1,6
12596.0,37.0,2,618.27,3,1,2,6
12597.0,96.0,5,3683.13,3,3,4,10
12598.0,30.0,15,4414.67,3,4,4,11
12599.0,34.0,13,2296.72,3,4,4,11
12600.0,30.0,26,4955.79,3,4,4,11
12601.0,40.0,7,673.76,3,3,2,8
12602.0,1.0,1,153.12,3,1,1,5
12603.0,0.0,1,739.1999999999999,4,1,2,7
12604.0,0.0,2,254.18,4,1,1,6
12605.0,366.0,5,1217.95,1,3,3,7
12606.0,0.0,1,21.0,4,1,1,6
12607.0,1.0,2,3.552713678800501e-15,3,1,1,5
12608.0,0.0,1,415.79,4,1,2,7
12609.0,188.0,10,3417.86,2,4,4,10
12610.0,33.0,7,2057.99,3,3,3,9
12611.0,0.0,1,1193.32,4,1,3,8
12612.0,0.0,2,643.59,4,1,2,7
12613.0,122.0,13,6591.52,2,4,4,10
12614.0,161.0,1,315.6,2,1,1,4
12615.0,152.0,11,5564.88,2,4,4,10
12616.0,216.0,7,1045.35,2,3,3,8
12617.0,61.0,1,355.53,3,1,2,6
12618.0,0.0,1,177.31,4,1,1,6
12619.0,61.0,14,3354.95,3,4,4,11
12620.0,0.0,3,1339.41,4,2,3,9
12621.0,6.0,44,24579.31,3,4,4,11
12622.0,0.0,1,180.1,4,1,1,6
12623.0,130.0,9,3639.84,2,4,4,10
12624.0,0.0,2,641.13,4,1,2,7
12625.0,6.0,5,5095.38,3,3,4,10
12626.0,157.0,13,6388.35,2,4,4,10
12627.0,184.0,7,4478.53,2,3,4,9
12628.0,183.0,4,769.61,2,2,2,6
12629.0,366.0,2,1558.22,1,1,3,5
12630.0,0.0,2,1270.88,4,1,3,8
12631.0,458.0,7,3452.27,1,3,4,8
12632.0,522.0,4,738.88,1,2,2,5
12633.0,1.0,10,5595.21,3,4,4,11
12634.0,461.0,2,490.0,1,1,2,4
12635.0,32.0,4,2930.41,3,2,4,9
12636.0,1063.0,1,141.0,1,1,1,3
12637.0,93.0,14,8271.66,3,4,4,11
12638.0,183.0,2,921.49,2,1,3,6
12639.0,700.0,3,1312.37,1,2,3,6
12640.0,0.0,3,1174.58,4,2,3,9
12641.0,0.0,1,185.9,4,1,1,6
12642.0,0.0,3,1013.26,4,2,3,9
12643.0,40.0,14,7880.9,3,4,4,11
12644.0,306.0,6,1815.54,2,3,3,8
12645.0,183.0,10,3499.1,2,4,4,10
12646.0,213.0,2,1346.97,2,1,3,6
12647.0,32.0,45,17682.79,3,4,4,11
12648.0,126.0,5,1097.0,2,3,3,8
12649.0,36.0,10,2238.7,3,4,4,11
12650.0,182.0,1,314.44,2,1,1,4
12651.0,101.0,5,365.3,2,3,2,7
12652.0,10.0,3,1011.58,3,2,3,8
12653.0,703.0,3,4160.83,1,2,4,7
12654.0,303.0,5,601.98,2,3,2,7
12655.0,366.0,1,261.35,1,1,1,3
12656.0,3.0,12,6320.78,3,4,4,11
12657.0,0.0,5,1152.06,4,3,3,10
12658.0,0.0,1,686.05,4,1,2,7
12659.0,61.0,1,91.68,3,1,1,5
12660.0,0.0,1,245.1,4,1,1,6
12661.0,0.0,1,162.0,4,1,1,6
12662.0,90.0,22,6949.17,3,4,4,11
12663.0,465.0,3,204.0,1,2,1,4
12664.0,1.0,12,6052.04,3,4,4,11
12665.0,10.0,5,301.45,3,3,1,7
12666.0,426.0,2,1020.98,1,1,3,5
12667.0,1.0,1,620.13,3,1,2,6
12668.0,221.0,12,11380.710000000001,2,4,4,10
12669.0,4.0,4,1607.73,3,2,3,8
12670.0,61.0,8,3750.39,3,3,4,10
12671.0,372.0,1,2622.481,1,1,4,6
12672.0,0.0,3,410.5,4,2,2,8
12673.0,243.0,3,1230.02,2,2,3,7
12674.0,93.0,7,1919.31,3,3,3,9
12675.0,432.0,4,934.8,1,2,3,6
12676.0,125.0,12,2773.09,2,4,4,10
12677.0,404.0,3,389.3,1,2,2,5
12678.0,219.0,23,33851.13,2,4,4,10
12679.0,1.0,9,1058.67,3,4,3,10
12680.0,32.0,4,880.81,3,2,3,8
12681.0,34.0,56,30551.76,3,4,4,11
12682.0,3.0,53,23945.81,3,4,4,11
12683.0,6.0,27,12418.6,3,4,4,11
12684.0,67.0,7,2283.63,3,3,4,10
12685.0,30.0,6,2863.08,3,3,4,10
12686.0,639.0,1,178.28,1,1,1,3
12687.0,0.0,2,2138.91,4,1,3,8
12688.0,0.0,1,4873.8099999999995,4,1,4,9
12689.0,247.0,2,1247.61,2,1,3,6
12690.0,0.0,1,389.01,4,1,2,7
12691.0,1.0,7,1170.4,3,3,3,9
12692.0,373.0,1,110.95,1,1,1,3
12693.0,6.0,11,1640.42,3,4,3,10
12694.0,95.0,4,1839.45,3,2,3,8
12695.0,245.0,7,1407.1200000000001,2,3,3,8
12696.0,700.0,3,801.15,1,2,2,5
12697.0,30.0,5,939.02,3,3,3,9
12698.0,0.0,1,339.75,4,1,2,7
12699.0,0.0,1,638.11,4,1,2,7
12700.0,128.0,6,4867.99,2,3,4,9
12701.0,37.0,6,2446.41,3,3,4,10
12702.0,0.0,1,219.0,4,1,1,6
12703.0,183.0,7,892.18,2,3,3,8
12704.0,244.0,10,2220.84,2,4,4,10
12705.0,129.0,22,11554.0,2,4,4,10
12706.0,0.0,1,-91.89,4,1,1,6
12707.0,0.0,1,603.42,4,1,2,7
12708.0,38.0,30,5118.16,3,4,4,11
12709.0,1.0,55,30312.61,3,4,4,11
12710.0,246.0,4,1130.57,2,2,3,7
12711.0,525.0,2,1339.05,1,1,3,5
12712.0,10.0,28,6979.66,3,4,4,11
12713.0,90.0,1,848.55,3,1,3,7
12714.0,458.0,12,14093.71,1,4,4,9
12715.0,0.0,1,353.86,4,1,2,7
12716.0,182.0,2,1053.49,2,1,3,6
12717.0,34.0,4,1258.91,3,2,3,8
12718.0,0.0,1,238.25,4,1,1,6
12719.0,31.0,3,608.1,3,2,2,7
12720.0,4.0,41,8047.88,3,4,4,11
12721.0,95.0,10,3906.68,3,4,4,11
12722.0,4.0,6,904.33,3,3,3,9
12723.0,182.0,5,725.07,2,3,2,7
12724.0,40.0,7,2317.52,3,3,4,10
12725.0,615.0,4,2694.56,1,2,4,7
12726.0,30.0,11,4014.6,3,4,4,11
12727.0,216.0,12,5646.53,2,4,4,10
12728.0,40.0,5,1070.17,3,3,3,9
12729.0,0.0,1,453.01,4,1,2,7
12730.0,552.0,1,829.25,1,1,2,4
12731.0,36.0,19,25673.21,3,4,4,11
12732.0,0.0,1,236.26000000000002,4,1,1,6
12733.0,0.0,6,2326.82,4,3,4,11
12734.0,365.0,3,639.65,2,2,2,6
12735.0,193.0,2,779.5699999999999,2,1,2,5
12736.0,40.0,1,234.0,3,1,1,5
12737.0,0.0,2,3710.5,4,1,4,9
12738.0,666.0,1,310.7,1,1,1,3
12739.0,335.0,4,2726.73,2,2,4,8
12740.0,154.0,1,427.6,2,1,2,5
12741.0,0.0,2,406.07,4,1,2,7
12742.0,0.0,2,1185.02,4,1,3,8
12743.0,0.0,2,546.43,4,1,2,7
12744.0,221.0,14,13158.16,2,4,4,10
12745.0,429.0,3,925.41,1,2,3,6
12746.0,851.0,3,230.85000000000002,1,2,1,4
12747.0,152.0,32,9164.59,2,4,4,10
12748.0,5.0,365,49970.13,3,4,4,11
12749.0,33.0,16,6328.49,3,4,4,11
12750.0,278.0,1,275.88,2,1,1,4
12751.0,0.0,1,268.27,4,1,1,6
12752.0,0.0,1,4366.78,4,1,4,9
12753.0,100.0,11,21024.01,3,4,4,11
12754.0,161.0,5,2949.12,2,3,4,9
12755.0,161.0,22,6406.349999999999,2,4,4,10
12756.0,0.0,1,112.07999999999998,4,1,1,6
12757.0,5.0,19,4227.7,3,4,4,11
12758.0,130.0,8,9779.0,2,3,4,9
12759.0,99.0,8,5020.74,3,3,4,10
12760.0,428.0,1,347.8,1,1,2,4
12761.0,489.0,2,782.95,1,1,2,4
12762.0,302.0,2,1898.52,2,1,3,6
12763.0,578.0,2,814.16,1,1,2,4
12764.0,0.0,1,1693.88,4,1,3,8
12765.0,494.0,6,1404.58,1,3,3,7
12766.0,101.0,11,10026.43,2,4,4,10
12767.0,0.0,1,949.82,4,1,3,8
12768.0,610.0,2,3.552713678800501e-15,1,1,1,3
12769.0,0.0,1,1143.6,4,1,3,8
12770.0,458.0,7,2975.95,1,3,4,8
12771.0,398.0,2,262.5,1,1,1,3
12772.0,31.0,1,892.47,3,1,3,7
12773.0,0.0,2,1.7763568394002505e-15,4,1,1,6
12774.0,0.0,1,98.7,4,1,1,6
12775.0,280.0,8,1651.32,2,3,3,8
12776.0,435.0,1,55.5,1,1,1,3
12777.0,489.0,1,519.45,1,1,2,4
12778.0,96.0,10,1757.68,3,4,3,10
12779.0,221.0,21,6406.76,2,4,4,10
12780.0,0.0,1,337.4,4,1,2,7
12781.0,154.0,5,707.72,2,3,2,7
12782.0,213.0,14,4526.04,2,4,4,10
12783.0,152.0,8,1603.87,2,3,3,8
12784.0,0.0,3,1804.75,4,2,3,9
12785.0,152.0,5,1079.31,2,3,3,8
12786.0,463.0,1,728.5,1,1,2,4
12787.0,93.0,5,859.18,3,3,3,9
12788.0,670.0,4,444.9,1,2,2,5
12789.0,215.0,3,273.35,2,2,1,5
12790.0,0.0,3,563.45,4,2,2,8
12791.0,365.0,8,777.75,2,3,2,7
12792.0,0.0,3,813.88,4,2,2,8
12793.0,101.0,3,1017.33,2,2,3,7
12794.0,305.0,2,860.41,2,1,3,6
12795.0,0.0,1,430.48,4,1,2,7
12796.0,0.0,1,381.0,4,1,2,7
12797.0,396.0,6,725.46,1,3,2,6
12798.0,0.0,4,8510.93,4,2,4,10
12799.0,0.0,1,219.35,4,1,1,6
12800.0,708.0,3,584.25,1,2,2,5
12801.0,0.0,2,1031.87,4,1,3,8
12802.0,96.0,9,2350.42,3,4,4,11
12803.0,395.0,1,1092.81,1,1,3,5
12804.0,0.0,2,327.02,4,1,2,7
12805.0,649.0,4,1434.95,1,2,3,6
12806.0,0.0,4,2878.96,4,2,4,10
12807.0,0.0,3,269.95,4,2,1,7
12808.0,127.0,5,906.1,2,3,3,8
12809.0,495.0,8,1705.34,1,3,3,7
12810.0,708.0,2,534.99,1,1,2,4
12811.0,488.0,5,1033.9,1,3,3,7
12812.0,0.0,1,229.64000000000001,4,1,1,6
12813.0,432.0,3,1687.8,1,2,3,6
12814.0,0.0,1,125.92,4,1,1,6
12815.0,0.0,2,1063.46,4,1,3,8
12816.0,216.0,2,572.2,2,1,2,5
12817.0,283.0,3,690.98,2,2,2,6
12818.0,0.0,2,1517.88,4,1,3,8
12819.0,520.0,1,540.52,1,1,2,4
12820.0,182.0,13,2647.94,2,4,4,10
12821.0,97.0,2,220.8,3,1,1,5
12822.0,0.0,3,918.98,4,2,3,9
12823.0,246.0,18,6501.5,2,4,4,10
12824.0,31.0,1,397.12,3,1,2,6
12825.0,495.0,2,518.63,1,1,2,4
12826.0,61.0,15,2928.69,3,4,4,11
12827.0,153.0,3,430.15000000000003,2,2,2,6
12828.0,152.0,6,1018.71,2,3,3,8
12829.0,163.0,4,345.35,2,2,2,6
12830.0,93.0,7,6748.4,3,3,4,10
12831.0,670.0,3,451.11,1,2,2,5
12832.0,153.0,2,383.03,2,1,2,5
12833.0,0.0,1,417.38,4,1,2,7
12834.0,311.0,1,312.38,2,1,1,4
12835.0,368.0,49,6018.67,1,4,4,9
12836.0,31.0,17,6546.47,3,4,4,11
12837.0,0.0,2,688.41,4,1,2,7
12838.0,183.0,12,3376.03,2,4,4,10
12839.0,96.0,31,9927.83,3,4,4,11
12840.0,66.0,11,4013.87,3,4,4,11
12841.0,5.0,42,7390.4800000000005,3,4,4,11
12842.0,253.0,4,1917.99,2,2,3,7
12843.0,67.0,34,6345.61,3,4,4,11
12844.0,61.0,4,648.6,3,2,2,7
12845.0,0.0,4,354.09,4,2,2,8
12846.0,0.0,1,15.58,4,1,1,6
12847.0,0.0,2,1636.8999999999999,4,1,3,8
12848.0,677.0,1,208.0,1,1,1,3
12849.0,122.0,6,3090.56,2,3,4,9
12850.0,0.0,1,330.0,4,1,2,7
12851.0,246.0,2,284.13,2,1,1,4
12852.0,0.0,2,299.75,4,1,1,6
12853.0,97.0,16,3728.5,3,4,4,11
12854.0,7.0,11,2922.37,3,4,4,11
12855.0,426.0,4,650.9399999999999,1,2,2,5
12856.0,30.0,8,2162.68,3,3,3,9
12857.0,70.0,7,3684.25,3,3,4,10
12858.0,0.0,2,151.73,4,1,1,6
12859.0,520.0,1,575.1,1,1,2,4
12860.0,0.0,1,55.47,4,1,1,6
12861.0,0.0,1,68.25,4,1,1,6
12862.0,427.0,2,1008.3199999999999,1,1,3,5
12863.0,431.0,7,2775.5499999999997,1,3,4,8
12864.0,0.0,2,299.57,4,1,1,6
12865.0,125.0,5,3303.31,2,3,4,9
12866.0,342.0,3,1227.35,2,2,3,7
12867.0,97.0,16,7862.69,3,4,4,11
12868.0,10.0,8,2247.06,3,3,4,10
12869.0,0.0,1,337.66999999999996,4,1,2,7
12870.0,486.0,4,1647.15,1,2,3,6
12871.0,0.0,3,744.02,4,2,2,8
12872.0,367.0,13,3678.34,1,4,4,9
12873.0,311.0,3,2027.3,2,2,3,7
12874.0,645.0,3,933.42,1,2,3,6
12875.0,364.0,5,1356.99,2,3,3,8
12876.0,426.0,5,4068.59,1,3,4,8
12877.0,156.0,20,2955.17,2,4,4,10
12878.0,0.0,3,841.64,4,2,2,8
12879.0,93.0,4,552.5699999999999,3,2,2,7
12880.0,0.0,2,640.13,4,1,2,7
12881.0,99.0,1,298.0,3,1,1,5
12882.0,183.0,2,1463.04,2,1,3,6
12883.0,32.0,4,703.47,3,2,2,7
12884.0,2.0,1,309.05,3,1,1,5
12885.0,33.0,4,1158.27,3,2,3,8
12886.0,67.0,3,1351.09,3,2,3,8
12887.0,0.0,1,222.4,4,1,1,6
12888.0,97.0,4,313.77,3,2,1,6
12889.0,520.0,6,365.66,1,3,2,6
12890.0,0.0,2,717.27,4,1,2,7
12891.0,158.0,12,819.5,2,4,2,8
12892.0,487.0,1,263.38,1,1,1,3
12893.0,91.0,1,188.14,3,1,1,5
12894.0,0.0,1,157.35,4,1,1,6
12895.0,0.0,3,347.3,4,2,2,8
12896.0,820.0,1,-29.75,1,1,1,3
12897.0,39.0,4,514.25,3,2,2,7
12898.0,670.0,2,310.96000000000004,1,1,1,3
12899.0,0.0,1,366.4,4,1,2,7
12900.0,0.0,1,340.33,4,1,2,7
12901.0,36.0,36,16293.1,3,4,4,11
12902.0,0.0,1,138.68,4,1,1,6
12903.0,519.0,1,833.53,1,1,2,4
12904.0,0.0,2,509.58,4,1,2,7
12905.0,371.0,3,1011.82,1,2,3,6
12906.0,0.0,5,2919.81,4,3,4,11
12907.0,456.0,3,440.36,1,2,2,5
12908.0,1.0,7,1272.0,3,3,3,9
12909.0,339.0,13,3034.77,2,4,4,10
12910.0,7.0,14,5747.02,3,4,4,11
12911.0,553.0,1,1680.47,1,1,3,5
12912.0,152.0,5,1662.3,2,3,3,8
12913.0,39.0,13,6700.860000000001,3,4,4,11
12914.0,609.0,1,223.98,1,1,1,3
12915.0,524.0,8,1084.85,1,3,3,7
12916.0,402.0,8,4630.22,1,3,4,8
12917.0,278.0,8,4329.5,2,3,4,9
12918.0,0.0,3,-10953.5,4,2,1,7
12919.0,3.0,8,1301.44,3,3,3,9
12920.0,0.0,4,488.09000000000003,4,2,2,8
12921.0,5.0,103,34639.45,3,4,4,11
12922.0,338.0,1,405.38,2,1,2,5
12923.0,184.0,3,789.87,2,2,2,6
12924.0,2.0,14,2423.15,3,4,4,11
12925.0,213.0,3,729.3299999999999,2,2,2,6
12926.0,676.0,4,1548.46,1,2,3,6
12927.0,426.0,1,197.31,1,1,1,3
12928.0,7.0,12,4304.89,3,4,4,11
12929.0,94.0,2,105.1,3,1,1,5
12930.0,0.0,4,409.9,4,2,2,8
12931.0,30.0,71,71299.67,3,4,4,11
12932.0,435.0,8,1698.56,1,3,3,7
12933.0,342.0,11,1627.28,2,4,3,9
12934.0,1004.0,1,181.65,1,1,1,3
12935.0,151.0,19,4182.01,2,4,4,10
12936.0,0.0,5,1012.9,4,3,3,10
12937.0,368.0,9,3097.61,1,4,4,9
12938.0,0.0,1,114.14,4,1,1,6
12939.0,38.0,20,25264.8,3,4,4,11
12940.0,0.0,4,876.29,4,2,3,9
12941.0,0.0,1,377.49,4,1,2,7
12942.0,455.0,3,942.65,1,2,3,6
12943.0,39.0,4,489.0,3,2,2,7
12944.0,244.0,2,604.51,2,1,2,5
12945.0,0.0,2,900.11,4,1,3,8
12946.0,0.0,1,324.45,4,1,1,6
12947.0,66.0,11,1711.33,3,4,3,10
12948.0,31.0,10,2306.18,3,4,4,11
12949.0,91.0,28,15391.0,3,4,4,11
12950.0,152.0,3,1843.0,2,2,3,7
12951.0,221.0,20,3164.42,2,4,4,10
12952.0,61.0,5,1382.8400000000001,3,3,3,9
12953.0,583.0,2,828.8100000000001,1,1,2,4
12954.0,403.0,1,162.45,1,1,1,3
12955.0,121.0,14,4734.26,2,4,4,10
12956.0,192.0,4,521.89,2,2,2,6
12957.0,188.0,21,8628.42,2,4,4,10
12958.0,585.0,2,539.49,1,1,2,4
12959.0,367.0,2,133.35,1,1,1,3
12960.0,401.0,4,1322.07,1,2,3,6
12961.0,0.0,1,211.99,4,1,1,6
12962.0,302.0,2,266.39,2,1,1,4
12963.0,333.0,14,3512.79,2,4,4,10
12964.0,0.0,1,132.24,4,1,1,6
12965.0,32.0,1,771.91,3,1,2,6
12966.0,0.0,1,160.18,4,1,1,6
12967.0,70.0,5,3840.77,3,3,4,10
12968.0,0.0,1,135.95,4,1,1,6
12969.0,0.0,1,122.45,4,1,1,6
12970.0,302.0,10,1524.97,2,4,3,9
12971.0,10.0,120,15482.74,3,4,4,11
12972.0,554.0,6,1115.95,1,3,3,7
12973.0,0.0,1,385.55,4,1,2,7
12974.0,0.0,2,408.95,4,1,2,7
12975.0,491.0,8,1993.99,1,3,3,7
12976.0,6.0,8,3156.38,3,3,4,10
12977.0,187.0,4,517.63,2,2,2,6
12978.0,528.0,6,2496.07,1,3,4,8
12979.0,790.0,2,479.53999999999996,1,1,2,4
12980.0,10.0,26,15909.390000000001,3,4,4,11
12981.0,61.0,2,372.21999999999997,3,1,2,6
12982.0,37.0,17,2562.12,3,4,4,11
12983.0,0.0,1,490.08000000000004,4,1,2,7
12984.0,0.0,1,97.5,4,1,1,6
12985.0,30.0,3,1215.6200000000001,3,2,3,8
12986.0,495.0,12,1991.5900000000001,1,4,3,8
12987.0,339.0,6,1298.51,2,3,3,8
12988.0,0.0,1,535.32,4,1,2,7
12989.0,2.0,39,12846.8,3,4,4,11
12990.0,122.0,7,955.5,2,3,3,8
12991.0,0.0,3,764.82,4,2,2,8
12992.0,0.0,1,93.35000000000001,4,1,1,6
12993.0,33.0,10,1191.26,3,4,3,10
12994.0,33.0,5,902.22,3,3,3,9
12995.0,0.0,2,200.72,4,1,1,6
12996.0,0.0,1,355.5,4,1,2,7
12997.0,2.0,16,2065.11,3,4,3,10
12998.0,494.0,4,897.38,1,2,3,6
12999.0,129.0,3,455.88,2,2,2,6
13000.0,425.0,5,965.0,1,3,3,7
13001.0,127.0,37,24136.05,2,4,4,10
13002.0,700.0,3,414.13,1,2,2,5
13003.0,34.0,3,149.05,3,2,1,6
13004.0,71.0,46,11143.99,3,4,4,11
13005.0,129.0,6,935.03,2,3,3,8
13006.0,0.0,1,81.57,4,1,1,6
13007.0,462.0,1,175.25,1,1,1,3
13008.0,464.0,7,543.28,1,3,2,6
13009.0,588.0,1,234.0,1,1,1,3
13010.0,707.0,2,330.12,1,1,2,4
13011.0,666.0,1,101.10000000000001,1,1,1,3
13012.0,36.0,15,2591.1800000000003,3,4,4,11
13013.0,4.0,31,12601.82,3,4,4,11
13014.0,67.0,18,5220.83,3,4,4,11
13015.0,129.0,14,6465.72,2,4,4,10
13016.0,125.0,3,789.89,2,2,2,6
13017.0,302.0,1,204.0,2,1,1,4
13018.0,91.0,37,9742.81,3,4,4,11
13019.0,372.0,8,1212.95,1,3,3,7
13020.0,461.0,5,606.96,1,3,2,6
13021.0,39.0,24,4786.38,3,4,4,11
13022.0,549.0,1,65.3,1,1,1,3
13023.0,184.0,3,1449.03,2,2,3,7
13024.0,554.0,3,535.42,1,2,2,5
13025.0,851.0,1,323.39,1,1,1,3
13026.0,99.0,13,1690.12,3,4,3,10
13027.0,157.0,23,17148.0,2,4,4,10
13028.0,334.0,3,659.68,2,2,2,6
13029.0,91.0,5,1927.3,3,3,3,9
13030.0,547.0,2,1227.22,1,1,3,5
13031.0,582.0,5,3419.27,1,3,4,8
13032.0,334.0,11,2817.59,2,4,4,10
13033.0,549.0,2,220.55,1,1,1,3
13034.0,578.0,3,922.68,1,2,3,6
13035.0,610.0,4,1328.95,1,2,3,6
13036.0,0.0,1,307.1,4,1,1,6
13037.0,250.0,16,3842.55,2,4,4,10
13038.0,96.0,3,908.46,3,2,3,8
13039.0,615.0,4,1010.73,1,2,3,6
13040.0,183.0,2,676.99,2,1,2,5
13041.0,583.0,4,799.13,1,2,2,5
13042.0,615.0,4,1522.79,1,2,3,6
13043.0,38.0,2,471.57,3,1,2,6
13044.0,369.0,13,4824.2,1,4,4,9
13045.0,336.0,3,808.92,2,2,2,6
13046.0,91.0,3,949.25,3,2,3,8
13047.0,122.0,42,8466.72,2,4,4,10
13048.0,0.0,13,4035.16,4,4,4,12
13049.0,184.0,5,1384.14,2,3,3,8
13050.0,39.0,57,11822.44,3,4,4,11
13051.0,432.0,2,155.8,1,1,1,3
13052.0,36.0,7,3168.53,3,3,4,10
13053.0,0.0,1,127.65,4,1,1,6
13054.0,0.0,1,-14.0,4,1,1,6
13055.0,67.0,6,2292.5099999999998,3,3,4,10
13056.0,553.0,1,209.48,1,1,1,3
13057.0,0.0,4,540.74,4,2,2,8
13058.0,1.0,3,271.40000000000003,3,2,1,6
13059.0,251.0,12,2272.62,2,4,4,10
13060.0,0.0,1,307.53,4,1,1,6
13061.0,0.0,1,248.61,4,1,1,6
13062.0,339.0,1,346.98,2,1,2,5
13063.0,0.0,1,188.4,4,1,1,6
13064.0,2.0,6,1680.74,3,3,3,9
13065.0,365.0,6,1255.96,2,3,3,8
13066.0,153.0,3,430.9,2,2,2,6
13067.0,0.0,3,508.51,4,2,2,8
13068.0,0.0,2,344.0,4,1,2,7
13069.0,3.0,42,8747.47,3,4,4,11
13070.0,550.0,5,743.9,1,3,2,6
13071.0,555.0,1,129.22,1,1,1,3
13072.0,0.0,1,177.15,4,1,1,6
13073.0,0.0,2,418.08,4,1,2,7
13074.0,706.0,5,1362.8400000000001,1,3,3,7
13075.0,306.0,1,919.61,2,1,3,6
13076.0,489.0,1,135.4,1,1,1,3
13077.0,120.0,14,3040.17,2,4,4,10
13078.0,1.0,95,28883.83,3,4,4,11
13079.0,93.0,6,419.18,3,3,2,8
13080.0,463.0,5,260.83,1,3,1,5
13081.0,61.0,44,58328.15,3,4,4,11
13082.0,217.0,25,7268.92,2,4,4,10
13083.0,213.0,3,395.43,2,2,2,6
13084.0,459.0,2,116.44999999999999,1,1,1,3
13085.0,218.0,10,1459.46,2,4,3,9
13086.0,0.0,1,439.33000000000004,4,1,2,7
13087.0,0.0,1,313.64,4,1,1,6
13088.0,0.0,1,236.11,4,1,1,6
13089.0,7.0,247,113214.19,3,4,4,11
13090.0,122.0,30,13771.28,2,4,4,10
13091.0,30.0,6,-130.21999999999997,3,3,1,7
13092.0,6.0,15,2007.33,3,4,3,10
13093.0,10.0,88,54073.729999999996,3,4,4,11
13094.0,39.0,17,2214.6600000000003,3,4,4,11
13095.0,0.0,1,74.39999999999999,4,1,1,6
13096.0,426.0,1,419.70000000000005,1,1,2,4
13097.0,94.0,40,12861.73,3,4,4,11
13098.0,7.0,41,28658.88,3,4,4,11
13099.0,335.0,1,207.35999999999999,2,1,1,4
13100.0,0.0,1,-1598.67,4,1,1,6
13101.0,0.0,4,695.4,4,2,2,8
13102.0,39.0,42,11440.12,3,4,4,11
13103.0,401.0,3,709.64,1,2,2,5
13104.0,182.0,9,1709.1,2,4,3,9
13105.0,0.0,1,72.0,4,1,1,6
13106.0,278.0,3,586.46,2,2,2,6
13107.0,71.0,15,5109.62,3,4,4,11
13108.0,667.0,2,1098.52,1,1,3,5
13109.0,31.0,7,1107.58,3,3,3,9
13110.0,70.0,14,2896.17,3,4,4,11
13111.0,0.0,1,321.88000000000005,4,1,1,6
13112.0,850.0,3,-5.44,1,2,1,4
13113.0,6.0,60,16600.25,3,4,4,11
13114.0,820.0,1,234.38,1,1,1,3
13115.0,1.0,23,5374.45,3,4,4,11
13116.0,0.0,2,485.19,4,1,2,7
13117.0,64.0,19,2642.11,3,4,4,11
13118.0,579.0,12,2334.1,1,4,4,9
13119.0,465.0,1,134.9,1,1,1,3
13120.0,0.0,1,30.599999999999998,4,1,1,6
13121.0,0.0,2,254.73,4,1,1,6
13122.0,185.0,2,922.39,2,1,3,6
13123.0,0.0,2,506.75,4,1,2,7
13124.0,32.0,4,4782.45,3,2,4,9
13125.0,613.0,1,158.57,1,1,1,3
13126.0,40.0,19,3902.47,3,4,4,11
13127.0,0.0,1,259.17,4,1,1,6
13128.0,0.0,1,263.5,4,1,1,6
13129.0,0.0,2,233.25,4,1,1,6
13130.0,185.0,1,64.0,2,1,1,4
13131.0,183.0,8,3279.77,2,3,4,9
13132.0,0.0,1,77.3,4,1,1,6
13133.0,38.0,3,200.45000000000002,3,2,1,6
13134.0,96.0,9,2422.28,3,4,4,11
13135.0,581.0,2,3371.45,1,1,4,6
13136.0,1.0,24,6077.8,3,4,4,11
13137.0,30.0,17,7667.37,3,4,4,11
13138.0,426.0,8,1454.49,1,3,3,7
13139.0,128.0,9,8193.83,2,4,4,10
13140.0,486.0,5,1215.68,1,3,3,7
13141.0,97.0,21,7536.63,3,4,4,11
13142.0,0.0,1,307.09,4,1,1,6
13143.0,554.0,2,399.2,1,1,2,4
13144.0,40.0,2,135.35,3,1,1,5
13145.0,93.0,8,1419.77,3,3,3,9
13146.0,0.0,1,228.91,4,1,1,6
13147.0,91.0,4,712.8000000000001,3,2,2,7
13148.0,61.0,36,8123.6,3,4,4,11
13149.0,0.0,4,1676.06,4,2,3,9
13150.0,368.0,4,435.02,1,2,2,5
13151.0,0.0,5,2511.69,4,3,4,11
13152.0,583.0,9,2114.98,1,4,3,8
13153.0,243.0,1,486.22,2,1,2,5
13154.0,579.0,5,997.4300000000001,1,3,3,7
13155.0,183.0,6,1750.18,2,3,3,8
13156.0,465.0,3,1586.54,1,2,3,6
13157.0,7.0,10,5667.71,3,4,4,11
13158.0,3.0,5,1508.18,3,3,3,9
13159.0,333.0,5,1379.75,2,3,3,8
13160.0,0.0,1,91.8,4,1,1,6
13161.0,0.0,2,478.88,4,1,2,7
13162.0,40.0,19,9116.94,3,4,4,11
13163.0,494.0,2,0.0,1,1,1,3
13164.0,435.0,3,297.46000000000004,1,2,1,4
13165.0,0.0,3,1451.16,4,2,3,9
13166.0,311.0,3,881.68,2,2,3,7
13167.0,276.0,5,1125.15,2,3,3,8
13168.0,275.0,6,1866.26,2,3,3,8
13169.0,154.0,3,840.08,2,2,2,6
13170.0,0.0,1,116.00999999999999,4,1,1,6
13171.0,333.0,5,426.81,2,3,2,7
13172.0,609.0,1,69.6,1,1,1,3
13173.0,213.0,13,2620.5,2,4,4,10
13174.0,365.0,12,9494.84,2,4,4,10
13175.0,554.0,4,793.1,1,2,2,5
13176.0,0.0,1,492.84,4,1,2,7
13177.0,184.0,2,512.2,2,1,2,5
13178.0,97.0,25,13997.89,3,4,4,11
13179.0,0.0,1,572.3100000000001,4,1,2,7
13180.0,402.0,1,86.10000000000001,1,1,1,3
13181.0,0.0,1,359.69,4,1,2,7
13182.0,0.0,1,121.18,4,1,1,6
13183.0,101.0,18,7010.88,2,4,4,10
13184.0,34.0,12,1648.79,3,4,3,10
13185.0,0.0,1,71.4,4,1,1,6
13186.0,33.0,5,1539.69,3,3,3,9
13187.0,192.0,5,348.31,2,3,2,7
13188.0,0.0,1,114.60000000000001,4,1,1,6
13189.0,0.0,2,260.68,4,1,1,6
13190.0,882.0,4,518.76,1,2,2,5
13191.0,0.0,1,164.69,4,1,1,6
13192.0,216.0,8,2544.53,2,3,4,9
13193.0,92.0,1,117.88,3,1,1,5
13194.0,0.0,2,472.78,4,1,2,7
13195.0,0.0,1,172.38,4,1,1,6
13196.0,372.0,8,3059.64,1,3,4,8
13197.0,463.0,1,373.01000000000005,1,1,2,4
13198.0,33.0,12,4912.28,3,4,4,11
13199.0,122.0,69,16404.98,2,4,4,10
13200.0,217.0,4,870.09,2,2,3,7
13201.0,491.0,4,1240.6100000000001,1,2,3,6
13202.0,426.0,8,1571.35,1,3,3,7
13203.0,33.0,11,2630.55,3,4,4,11
13204.0,851.0,1,966.6600000000001,1,1,3,5
13205.0,0.0,1,2803.2,4,1,4,9
13206.0,401.0,15,8280.13,1,4,4,9
13207.0,4.0,4,535.86,3,2,2,7
13208.0,1.0,10,1970.5,3,4,3,10
13209.0,91.0,16,8438.06,3,4,4,11
13210.0,155.0,1,353.48,2,1,2,5
13211.0,215.0,12,2706.87,2,4,4,10
13212.0,92.0,4,780.58,3,2,2,7
13213.0,96.0,14,3834.62,3,4,4,11
13214.0,368.0,7,3264.23,1,3,4,8
13215.0,667.0,1,81.6,1,1,1,3
13216.0,0.0,1,333.74,4,1,2,7
13217.0,94.0,6,266.12,3,3,1,7
13218.0,247.0,1,62.63999999999999,2,1,1,4
13219.0,0.0,1,76.23,4,1,1,6
13220.0,158.0,5,1336.0900000000001,2,3,3,8
13221.0,0.0,2,847.41,4,1,3,8
13222.0,401.0,1,88.5,1,1,1,3
13223.0,366.0,6,969.1200000000001,1,3,3,7
13224.0,34.0,3,2150.85,3,2,3,8
13225.0,62.0,17,15879.27,3,4,4,11
13226.0,38.0,2,312.46,3,1,1,5
13227.0,0.0,1,257.7,4,1,1,6
13228.0,0.0,1,358.0,4,1,2,7
13229.0,0.0,1,160.95,4,1,1,6
13230.0,60.0,31,6317.22,3,4,4,11
13231.0,400.0,1,-355.2,1,1,1,3
13232.0,5.0,7,1357.6,3,3,3,9
13233.0,163.0,4,1176.46,2,2,3,7
13234.0,588.0,2,356.95,1,1,2,4
13235.0,6.0,2,101.17000000000007,3,1,1,5
13236.0,2.0,3,727.27,3,2,2,7
13237.0,0.0,1,643.0,4,1,2,7
13238.0,580.0,7,986.73,1,3,3,7
13239.0,582.0,6,1579.84,1,3,3,7
13240.0,246.0,9,1661.17,2,4,3,9
13241.0,0.0,1,115.58,4,1,1,6
13242.0,67.0,7,699.4,3,3,2,8
13243.0,0.0,5,1278.04,4,3,3,10
13244.0,124.0,1,121.74000000000001,2,1,1,4
13245.0,641.0,2,989.22,1,1,3,5
13246.0,395.0,14,3277.68,1,4,4,9
13247.0,0.0,4,501.12,4,2,2,8
13248.0,156.0,2,465.68,2,1,2,5
13249.0,124.0,9,1608.93,2,4,3,9
13250.0,581.0,3,248.54000000000002,1,2,1,4
13251.0,668.0,1,252.68,1,1,1,3
13252.0,426.0,3,341.3,1,2,2,5
13253.0,187.0,4,2951.11,2,2,4,8
13254.0,0.0,1,51.410000000000004,4,1,1,6
13255.0,182.0,4,895.61,2,2,3,7
13256.0,0.0,1,0.0,4,1,1,6
13257.0,488.0,3,117.95,1,2,1,4
13258.0,609.0,5,1035.18,1,3,3,7
13259.0,92.0,9,1433.38,3,4,3,10
13260.0,92.0,1,557.62,3,1,2,6
13261.0,0.0,2,944.1,4,1,3,8
13262.0,0.0,3,573.45,4,2,2,8
13263.0,6.0,39,8704.69,3,4,4,11
13264.0,0.0,1,722.5600000000001,4,1,2,7
13265.0,2.0,5,2107.66,3,3,3,9
13266.0,37.0,30,5965.3,3,4,4,11
13267.0,10.0,50,9512.210000000001,3,4,4,11
13268.0,7.0,15,3167.64,3,4,4,11
13269.0,2.0,30,8861.39,3,4,4,11
13270.0,486.0,1,1180.0,1,1,3,5
13271.0,303.0,2,178.26,2,1,1,4
13272.0,32.0,2,276.56,3,1,1,5
13273.0,0.0,1,138.98,4,1,1,6
13274.0,0.0,1,360.85,4,1,2,7
13275.0,0.0,2,241.66,4,1,1,6
13276.0,154.0,7,1918.56,2,3,3,8
13277.0,0.0,7,523.3,4,3,2,9
13278.0,494.0,5,1428.2,1,3,3,7
13279.0,183.0,2,126.30000000000001,2,1,1,4
13280.0,94.0,8,2297.13,3,3,4,10
13281.0,0.0,3,306.45,4,2,1,7
13282.0,6.0,7,1228.89,3,3,3,9
13283.0,31.0,4,373.36,3,2,2,7
13284.0,0.0,2,196.15,4,1,1,6
13285.0,338.0,6,3364.59,2,3,4,9
13286.0,0.0,1,734.91,4,1,2,7
13287.0,585.0,7,519.67,1,3,2,6
13288.0,404.0,6,892.16,1,3,3,7
13289.0,0.0,1,307.95,4,1,1,6
13290.0,580.0,3,-208.63,1,2,1,4
13291.0,157.0,11,3320.84,2,4,4,10
13292.0,334.0,6,987.79,2,3,3,8
13293.0,365.0,7,1180.34,2,3,3,8
13294.0,251.0,3,1689.53,2,2,3,7
13295.0,371.0,9,1058.02,1,4,3,8
13296.0,366.0,6,792.51,1,3,2,6
13297.0,276.0,8,4352.67,2,3,4,9
13298.0,121.0,1,360.0,2,1,2,5
13299.0,366.0,5,1173.3,1,3,3,7
13300.0,492.0,5,1267.21,1,3,3,7
13301.0,248.0,4,618.09,2,2,2,6
13302.0,156.0,2,159.2,2,1,1,4
13303.0,609.0,1,61.72,1,1,1,3
13304.0,400.0,7,1120.79,1,3,3,7
13305.0,38.0,16,3754.71,3,4,4,11
13306.0,580.0,1,53.65,1,1,1,3
13307.0,33.0,3,273.34,3,2,1,6
13308.0,308.0,5,1652.47,2,3,3,8
13309.0,2.0,6,1706.3700000000001,3,3,3,9
13310.0,29.0,8,1492.8,3,3,3,9
13311.0,4.0,2,598.57,3,1,2,6
13312.0,0.0,1,124.75,4,1,1,6
13313.0,128.0,15,3423.27,2,4,4,10
13314.0,121.0,4,578.66,2,2,2,6
13315.0,0.0,1,310.26,4,1,1,6
13316.0,303.0,12,12906.93,2,4,4,10
13317.0,95.0,31,6068.531,3,4,4,11
13318.0,120.0,3,640.76,2,2,2,6
13319.0,1.0,78,21706.09,3,4,4,11
13320.0,5.0,9,2160.95,3,4,3,10
13321.0,0.0,2,567.36,4,1,2,7
13322.0,0.0,1,199.48000000000002,4,1,1,6
13323.0,153.0,5,787.85,2,3,2,7
13324.0,7.0,23,10421.369999999999,3,4,4,11
13325.0,0.0,1,675.3,4,1,2,7
13326.0,641.0,1,281.76,1,1,1,3
13327.0,158.0,22,9741.03,2,4,4,10
13328.0,0.0,1,1308.48,4,1,3,8
13329.0,122.0,14,4977.0199999999995,2,4,4,10
13330.0,124.0,6,2806.18,2,3,4,9
13331.0,640.0,1,262.4,1,1,1,3
13332.0,0.0,1,350.9,4,1,2,7
13333.0,489.0,3,1015.74,1,2,3,6
13334.0,162.0,6,6257.0,2,3,4,9
13335.0,0.0,1,-955.06,4,1,1,6
13336.0,0.0,1,795.12,4,1,2,7
13337.0,400.0,2,1548.55,1,1,3,5
13338.0,126.0,10,2223.62,2,4,4,10
13339.0,0.0,1,860.12,4,1,3,8
13340.0,130.0,12,22100.56,2,4,4,10
13341.0,0.0,1,775.85,4,1,2,7
13342.0,554.0,1,-14.100000000000001,1,1,1,3
13343.0,0.0,2,303.93,4,1,1,6
13344.0,161.0,3,2543.72,2,2,4,8
13345.0,130.0,2,377.6,2,1,2,5
13346.0,642.0,6,299.4,1,3,1,5
13347.0,0.0,1,341.36,4,1,2,7
13348.0,183.0,1,233.76,2,1,1,4
13349.0,0.0,1,247.32,4,1,1,6
13350.0,0.0,3,910.72,4,2,3,9
13351.0,245.0,1,373.94,2,1,2,5
13352.0,62.0,2,389.28,3,1,2,6
13353.0,0.0,1,-28.849999999999998,4,1,1,6
13354.0,0.0,1,743.53,4,1,2,7
13355.0,94.0,1,674.7,3,1,2,6
13356.0,0.0,1,768.24,4,1,2,7
13357.0,671.0,5,3838.36,1,3,4,8
13358.0,0.0,1,439.03,4,1,2,7
13359.0,31.0,4,1001.96,3,2,3,8
13360.0,497.0,7,1464.1,1,3,3,7
13361.0,706.0,2,1450.5,1,1,3,5
13362.0,129.0,10,5357.57,2,4,4,10
13363.0,0.0,3,1723.86,4,2,3,9
13364.0,245.0,2,0.0,2,1,1,4
13365.0,183.0,4,2164.32,2,2,3,7
13366.0,0.0,1,56.160000000000004,4,1,1,6
13367.0,610.0,1,510.20000000000005,1,1,2,4
13368.0,193.0,5,1086.1,2,3,3,8
13369.0,455.0,2,572.03,1,1,2,4
13370.0,486.0,2,1442.64,1,1,3,5
13371.0,0.0,4,2271.46,4,2,4,10
13372.0,32.0,1,378.64,3,1,2,6
13373.0,62.0,6,7587.1900000000005,3,3,4,10
13374.0,0.0,2,422.8,4,1,2,7
13375.0,2.0,3,1786.48,3,2,3,8
13376.0,336.0,3,1019.76,2,2,3,7
13377.0,434.0,4,1495.43,1,2,3,6
13378.0,0.0,1,-756.4,4,1,1,6
13379.0,304.0,3,572.56,2,2,2,6
13380.0,641.0,1,62.4,1,1,1,3
13381.0,32.0,15,8185.02,3,4,4,11
13382.0,252.0,5,1387.58,2,3,3,8
13383.0,0.0,1,305.28000000000003,4,1,1,6
13384.0,64.0,15,6635.09,3,4,4,11
13385.0,0.0,1,534.57,4,1,2,7
13386.0,0.0,2,835.46,4,1,2,7
13387.0,0.0,1,189.44,4,1,1,6
13388.0,64.0,4,1135.7,3,2,3,8
13389.0,0.0,3,797.96,4,2,2,8
13390.0,0.0,1,544.08,4,1,2,7
13391.0,0.0,1,59.8,4,1,1,6
13392.0,0.0,1,91.14,4,1,1,6
13393.0,585.0,6,1105.85,1,3,3,7
13394.0,34.0,24,6323.88,3,4,4,11
13395.0,158.0,3,1180.23,2,2,3,7
13396.0,61.0,4,1325.29,3,2,3,8
13397.0,96.0,13,3094.11,3,4,4,11
13398.0,0.0,2,670.34,4,1,2,7
13399.0,490.0,3,275.4,1,2,1,4
13400.0,554.0,2,300.93,1,1,1,3
13401.0,0.0,1,-1834.14,4,1,1,6
13402.0,247.0,4,1535.13,2,2,3,7
13403.0,0.0,3,229.5,4,2,1,7
13404.0,36.0,2,252.49,3,1,1,5
13405.0,0.0,9,1196.561,4,4,3,11
13406.0,488.0,3,557.22,1,2,2,5
13407.0,432.0,6,2111.89,1,3,3,7
13408.0,4.0,135,50852.852,3,4,4,11
13409.0,0.0,1,-525.65,4,1,1,6
13410.0,219.0,12,2172.51,2,4,3,9
13411.0,0.0,1,213.55,4,1,1,6
13412.0,0.0,1,487.34999999999997,4,1,2,7
13413.0,434.0,8,345.8,1,3,2,6
13414.0,218.0,7,2482.24,2,3,4,9
13415.0,759.0,5,681.92,1,3,2,6
13416.0,1004.0,3,940.8000000000001,1,2,3,6
13417.0,213.0,7,1593.89,2,3,3,8
13418.0,31.0,37,11916.16,3,4,4,11
13419.0,154.0,1,221.06,2,1,1,4
13420.0,187.0,4,140.35,2,2,1,5
13421.0,429.0,11,4088.82,1,4,4,9
13422.0,184.0,2,2601.55,2,1,4,7
13423.0,519.0,1,217.03,1,1,1,3
13424.0,0.0,2,557.92,4,1,2,7
13425.0,462.0,8,3375.9300000000003,1,3,4,8
13426.0,32.0,24,8076.76,3,4,4,11
13427.0,33.0,6,1006.53,3,3,3,9
13428.0,0.0,3,499.98,4,2,2,8
13429.0,62.0,4,1006.8,3,2,3,8
13430.0,0.0,4,648.6899999999999,4,2,2,8
13431.0,2.0,9,3289.24,3,4,4,11
13432.0,555.0,2,439.1,1,1,2,4
13433.0,375.0,5,656.87,1,3,2,6
13434.0,246.0,5,1666.8600000000001,2,3,3,8
13435.0,217.0,11,4459.83,2,4,4,10
13436.0,121.0,1,196.89,2,1,1,4
13437.0,122.0,7,3408.06,2,3,4,9
13438.0,430.0,1,46.5,1,1,1,3
13439.0,703.0,3,986.61,1,2,3,6
13440.0,365.0,10,1213.95,2,4,3,9
13441.0,93.0,2,720.9,3,1,2,6
13442.0,435.0,3,419.87,1,2,2,5
13443.0,372.0,7,1247.71,1,3,3,7
13444.0,0.0,2,631.6800000000001,4,1,2,7
13445.0,0.0,1,241.89999999999998,4,1,1,6
13446.0,398.0,18,3608.86,1,4,4,9
13447.0,183.0,4,1104.23,2,2,3,7
13448.0,67.0,19,8447.75,3,4,4,11
13449.0,0.0,1,291.88,4,1,1,6
13450.0,32.0,14,4117.54,3,4,4,11
13451.0,5.0,13,7119.97,3,4,4,11
13452.0,0.0,3,729.8,4,2,2,8
13453.0,394.0,5,758.99,1,3,2,6
13454.0,495.0,1,219.87,1,1,1,3
13455.0,365.0,11,2773.82,2,4,4,10
13456.0,95.0,7,1737.8200000000002,3,3,3,9
13457.0,1004.0,4,143.27,1,2,1,4
13458.0,7.0,24,11850.62,3,4,4,11
13459.0,0.0,2,1160.4099999999999,4,1,3,8
13460.0,61.0,2,183.44,3,1,1,5
13461.0,334.0,8,4138.5,2,3,4,9
13462.0,95.0,6,1145.6,3,3,3,9
13463.0,0.0,1,-158.65,4,1,1,6
13464.0,1.0,7,3083.89,3,3,4,10
13465.0,674.0,2,931.12,1,1,3,5
13466.0,127.0,7,952.25,2,3,3,8
13467.0,275.0,2,1083.71,2,1,3,6
13468.0,1.0,87,13091.61,3,4,4,11
13469.0,0.0,1,82.4,4,1,1,6
13470.0,336.0,2,165.0,2,1,1,4
13471.0,121.0,4,2531.58,2,2,4,8
13472.0,670.0,2,592.24,1,1,2,4
13473.0,40.0,10,2410.98,3,4,4,11
13474.0,702.0,3,663.79,1,2,2,5
13475.0,189.0,4,1431.78,2,2,3,7
13476.0,69.0,7,1915.77,3,3,3,9
13477.0,6.0,13,2821.12,3,4,4,11
13478.0,649.0,7,2068.03,1,3,3,7
13479.0,0.0,7,808.5,4,3,2,9
13480.0,0.0,2,627.82,4,1,2,7
13481.0,251.0,14,3798.84,2,4,4,10
13482.0,0.0,2,336.09,4,1,2,7
13483.0,215.0,1,140.34,2,1,1,4
13484.0,7.0,4,767.32,3,2,2,7
13485.0,366.0,15,2957.92,1,4,4,9
13486.0,157.0,3,1122.41,2,2,3,7
13487.0,67.0,5,846.87,3,3,3,9
13488.0,10.0,29,15513.73,3,4,4,11
13489.0,218.0,4,449.52,2,2,2,6
13490.0,0.0,1,154.25,4,1,1,6
13491.0,40.0,27,4566.56,3,4,4,11
13492.0,97.0,3,1269.84,3,2,3,8
13493.0,99.0,2,618.63,3,1,2,6
13494.0,343.0,1,316.26000000000005,2,1,1,4
13495.0,244.0,13,5246.61,2,4,4,10
13496.0,0.0,3,617.93,4,2,2,8
13497.0,311.0,7,1266.33,2,3,3,8
13498.0,820.0,1,327.38,1,1,2,4
13499.0,61.0,7,1146.96,3,3,3,9
13500.0,30.0,5,1436.3,3,3,3,9
13501.0,37.0,5,2840.26,3,3,4,10
13502.0,69.0,6,774.6,3,3,2,8
13503.0,461.0,12,1793.54,1,4,3,8
13504.0,184.0,1,295.93,2,1,1,4
13505.0,276.0,8,4282.88,2,3,4,9
13506.0,455.0,8,1609.65,1,3,3,7
13507.0,182.0,4,2479.16,2,2,4,8
13508.0,68.0,2,287.05,3,1,1,5
13509.0,38.0,8,1114.72,3,3,3,9
13510.0,96.0,17,4488.39,3,4,4,11
13511.0,708.0,2,244.61,1,1,1,3
13512.0,585.0,4,713.39,1,2,2,5
13513.0,217.0,4,796.99,2,2,2,6
13514.0,462.0,4,815.9000000000001,1,2,2,5
13515.0,190.0,6,1265.82,2,3,3,8
13516.0,0.0,4,1685.26,4,2,3,9
13517.0,31.0,5,2109.07,3,3,3,9
13518.0,0.0,1,659.4399999999999,4,1,2,7
13519.0,0.0,3,331.26,4,2,2,8
13520.0,1.0,15,6680.65,3,4,4,11
13521.0,121.0,3,1093.65,2,2,3,7
13522.0,91.0,1,125.80000000000001,3,1,1,5
13523.0,183.0,7,4892.02,2,3,4,9
13524.0,250.0,5,680.1800000000001,2,3,2,7
13525.0,221.0,2,628.78,2,1,2,5
13526.0,1063.0,4,942.5999999999999,1,2,3,6
13527.0,32.0,14,4650.04,3,4,4,11
13528.0,0.0,1,-40.0,4,1,1,6
13529.0,0.0,2,307.76,4,1,1,6
13530.0,0.0,1,402.97999999999996,4,1,2,7
13531.0,486.0,6,1738.52,1,3,3,7
13532.0,183.0,1,210.31,2,1,1,4
13533.0,66.0,3,270.79,3,2,1,6
13534.0,39.0,60,7324.5,3,4,4,11
13535.0,668.0,1,89.5,1,1,1,3
13536.0,121.0,7,3448.29,2,3,4,9
13537.0,427.0,2,717.85,1,1,2,4
13538.0,33.0,12,3112.73,3,4,4,11
13539.0,284.0,9,1531.26,2,4,3,9
13540.0,0.0,3,632.39,4,2,2,8
13541.0,366.0,3,717.9,1,2,2,5
13542.0,427.0,18,3970.77,1,4,4,9
13543.0,0.0,2,1439.6100000000001,4,1,3,8
13544.0,587.0,7,820.5,1,3,2,6
13545.0,1063.0,3,347.35,1,2,2,5
13546.0,395.0,5,1092.14,1,3,3,7
13547.0,0.0,1,175.53,4,1,1,6
13548.0,68.0,3,908.99,3,2,3,8
13549.0,4.0,9,1003.72,3,4,3,10
13550.0,0.0,1,349.51,4,1,2,7
13551.0,404.0,2,244.2,1,1,1,3
13552.0,125.0,32,6618.63,2,4,4,10
13553.0,649.0,1,517.8,1,1,2,4
13554.0,549.0,10,1556.3899999999999,1,4,3,8
13555.0,0.0,16,8906.34,4,4,4,12
13556.0,549.0,2,200.82,1,1,1,3
13557.0,30.0,16,2980.08,3,4,4,11
13558.0,92.0,4,605.06,3,2,2,7
13559.0,0.0,2,990.0,4,1,3,8
13560.0,302.0,1,174.37,2,1,1,4
13561.0,128.0,11,1820.72,2,4,3,9
13562.0,129.0,8,4838.18,2,3,4,9
13563.0,0.0,2,777.53,4,1,2,7
13564.0,372.0,54,15786.720000000001,1,4,4,9
13565.0,101.0,3,414.8,2,2,2,6
13566.0,434.0,5,1708.1200000000001,1,3,3,7
13567.0,519.0,5,1078.59,1,3,3,7
13568.0,0.0,1,192.85,4,1,1,6
13569.0,517.0,4,893.78,1,2,3,6
13570.0,68.0,1,239.49,3,1,1,5
13571.0,124.0,26,4546.54,2,4,4,10
13572.0,0.0,1,1384.25,4,1,3,8
13573.0,373.0,6,916.47,1,3,3,7
13574.0,0.0,1,421.25,4,1,2,7
13575.0,1.0,5,732.0699999999999,3,3,2,8
13576.0,40.0,32,11516.15,3,4,4,11
13577.0,2.0,14,3346.62,3,4,4,11
13578.0,0.0,1,147.66,4,1,1,6
13579.0,428.0,6,1535.84,1,3,3,7
13580.0,0.0,1,107.75,4,1,1,6
13581.0,284.0,2,280.53000000000003,2,1,1,4
13582.0,706.0,2,241.68,1,1,1,3
13583.0,157.0,2,1445.031,2,1,3,6
13584.0,192.0,5,347.15,2,3,2,7
13585.0,432.0,4,674.46,1,2,2,5
13586.0,0.0,1,131.53,4,1,1,6
13587.0,122.0,6,1308.1,2,3,3,8
13588.0,30.0,13,2445.12,3,4,4,11
13589.0,462.0,6,1120.74,1,3,3,7
13590.0,4.0,21,6298.29,3,4,4,11
13591.0,184.0,8,2081.19,2,3,3,8
13592.0,67.0,4,247.95999999999998,3,2,1,6
13593.0,163.0,16,5475.21,2,4,4,10
13594.0,398.0,3,508.42,1,2,2,5
13595.0,399.0,3,818.22,1,2,2,5
13596.0,243.0,2,697.04,2,1,2,5
13597.0,609.0,3,372.21,1,2,2,5
13598.0,462.0,6,776.84,1,3,2,6
13599.0,4.0,52,9790.34,3,4,4,11
13600.0,0.0,2,518.42,4,1,2,7
13601.0,6.0,4,1185.14,3,2,3,8
13602.0,184.0,4,1025.17,2,2,3,7
13603.0,0.0,1,164.34,4,1,1,6
13604.0,0.0,2,713.39,4,1,2,7
13605.0,0.0,2,522.67,4,1,2,7
13606.0,60.0,3,280.53999999999996,3,2,1,6
13607.0,365.0,3,1060.6100000000001,2,2,3,7
13608.0,0.0,1,236.2,4,1,1,6
13609.0,0.0,1,167.35,4,1,1,6
13610.0,68.0,17,2144.13,3,4,3,10
13611.0,32.0,14,3281.03,3,4,4,11
13612.0,460.0,2,777.79,1,1,2,4
13613.0,0.0,5,1039.8500000000001,4,3,3,10
13614.0,32.0,6,2359.19,3,3,4,10
13615.0,368.0,12,6212.2300000000005,1,4,4,9
13616.0,0.0,2,288.1,4,1,1,6
13617.0,5.0,9,1263.8,3,4,3,10
13618.0,0.0,1,177.34,4,1,1,6
13619.0,649.0,2,231.69,1,1,1,3
13620.0,0.0,1,112.34,4,1,1,6
13621.0,0.0,1,213.85,4,1,1,6
13622.0,375.0,2,651.45,1,1,2,4
13623.0,91.0,15,2446.36,3,4,4,11
13624.0,0.0,2,427.18,4,1,2,7
13625.0,0.0,1,301.26,4,1,1,6
13626.0,341.0,3,689.49,2,2,2,6
13627.0,31.0,10,2217.55,3,4,4,11
13628.0,708.0,1,310.14,1,1,1,3
13629.0,91.0,19,13370.86,3,4,4,11
13630.0,127.0,11,1995.68,2,4,3,9
13631.0,336.0,12,3021.77,2,4,4,10
13632.0,68.0,10,3634.7000000000003,3,4,4,11
13633.0,0.0,1,-306.66,4,1,1,6
13634.0,37.0,17,4519.55,3,4,4,11
13635.0,276.0,6,2948.22,2,3,4,9
13636.0,94.0,6,941.62,3,3,3,9
13637.0,219.0,3,810.5,2,2,2,6
13638.0,0.0,1,122.64,4,1,1,6
13639.0,0.0,2,1346.27,4,1,3,8
13640.0,525.0,1,405.0,1,1,2,4
13641.0,464.0,7,921.82,1,3,3,7
13642.0,128.0,5,501.97,2,3,2,7
13643.0,122.0,15,2112.17,2,4,3,9
13644.0,333.0,5,2597.52,2,3,4,9
13645.0,33.0,1,252.1,3,1,1,5
13646.0,579.0,3,323.3,1,2,1,4
13647.0,184.0,9,3063.78,2,4,4,10
13648.0,527.0,11,1679.01,1,4,3,8
13649.0,486.0,6,1678.88,1,3,3,7
13650.0,2.0,16,3098.5,3,4,4,11
13651.0,244.0,4,208.95,2,2,1,5
13652.0,519.0,5,2570.85,1,3,4,8
13653.0,459.0,1,152.2,1,1,1,3
13654.0,37.0,11,6308.0,3,4,4,11
13655.0,7.0,8,2259.3,3,3,4,10
13656.0,193.0,7,1053.35,2,3,3,8
13657.0,0.0,2,382.14,4,1,2,7
13658.0,431.0,13,5772.07,1,4,4,9
13659.0,368.0,17,4716.63,1,4,4,9
13660.0,456.0,2,303.69,1,1,1,3
13661.0,0.0,1,325.24,4,1,2,7
13662.0,36.0,17,2183.13,3,4,4,11
13663.0,648.0,6,2013.6100000000001,1,3,3,7
13664.0,0.0,1,-13.14,4,1,1,6
13665.0,0.0,3,1711.6599999999999,4,2,3,9
13666.0,62.0,5,127.89999999999999,3,3,1,7
13667.0,0.0,1,305.02,4,1,1,6
13668.0,37.0,47,12749.14,3,4,4,11
13669.0,0.0,3,413.55,4,2,2,8
13670.0,0.0,1,349.7,4,1,2,7
13671.0,426.0,1,194.95,1,1,1,3
13672.0,39.0,7,162.07000000000002,3,3,1,7
13673.0,153.0,2,396.92,2,1,2,5
13674.0,549.0,2,215.88,1,1,1,3
13675.0,34.0,2,486.82000000000005,3,1,2,6
13676.0,0.0,3,153.15,4,2,1,7
13677.0,521.0,2,556.1899999999999,1,1,2,4
13678.0,34.0,1,232.6,3,1,1,5
13679.0,643.0,3,281.26,1,2,1,4
13680.0,121.0,13,9915.56,2,4,4,10
13681.0,157.0,4,827.83,2,2,2,6
13682.0,219.0,1,59.5,2,1,1,4
13683.0,489.0,1,258.6,1,1,1,3
13684.0,0.0,6,546.52,4,3,2,9
13685.0,62.0,7,3119.44,3,3,4,10
13686.0,66.0,3,409.04,3,2,2,7
13687.0,0.0,1,11880.84,4,1,4,9
13688.0,0.0,1,375.5,4,1,2,7
13689.0,154.0,2,1259.5,2,1,3,6
13690.0,31.0,1,172.25,3,1,1,5
13691.0,486.0,1,212.78,1,1,1,3
13692.0,67.0,8,3016.4500000000003,3,3,4,10
13693.0,365.0,13,1948.32,2,4,3,9
13694.0,62.0,164,190825.52,3,4,4,11
13695.0,3.0,16,2770.73,3,4,4,11
13696.0,404.0,4,2008.7,1,2,3,6
13697.0,334.0,1,151.29999999999998,2,1,1,4
13698.0,0.0,2,465.53000000000003,4,1,2,7
13699.0,157.0,3,711.4,2,2,2,6
13700.0,7.0,14,2586.21,3,4,4,11
13701.0,0.0,2,159.55,4,1,1,6
13702.0,0.0,1,135.18,4,1,1,6
13703.0,0.0,3,99.5,4,2,1,7
13704.0,1.0,10,2295.31,3,4,4,11
13705.0,302.0,7,2035.33,2,3,3,8
13706.0,70.0,2,631.17,3,1,2,6
13707.0,549.0,5,3365.86,1,3,4,8
13708.0,0.0,1,296.88,4,1,1,6
13709.0,1.0,22,7512.81,3,4,4,11
13710.0,122.0,3,509.52,2,2,2,6
13711.0,220.0,15,1632.6100000000001,2,4,3,9
13712.0,160.0,2,766.42,2,1,2,5
13713.0,585.0,3,743.26,1,2,2,5
13714.0,0.0,1,161.35,4,1,1,6
13715.0,192.0,21,8438.34,2,4,4,10
13716.0,0.0,1,138.28,4,1,1,6
13717.0,153.0,11,1748.05,2,4,3,9
13718.0,160.0,2,306.55,2,1,1,4
13719.0,183.0,11,2815.25,2,4,4,10
13720.0,0.0,4,799.9,4,2,2,8
13721.0,275.0,2,741.54,2,1,2,5
13722.0,33.0,11,5629.16,3,4,4,11
13723.0,189.0,6,1209.2,2,3,3,8
13724.0,373.0,1,213.01,1,1,1,3
13725.0,39.0,11,1809.81,3,4,3,10
13726.0,334.0,2,1079.6599999999999,2,1,3,6
13727.0,30.0,9,1067.3,3,4,3,10
13728.0,275.0,16,2855.17,2,4,4,10
13729.0,0.0,5,676.4300000000001,4,3,2,9
13730.0,338.0,2,752.6,2,1,2,5
13731.0,160.0,2,610.59,2,1,2,5
13732.0,30.0,1,491.86,3,1,2,6
13733.0,850.0,3,484.53000000000003,1,2,2,5
13734.0,460.0,6,3451.2900000000004,1,3,4,8
13735.0,426.0,22,9472.81,1,4,4,9
13736.0,243.0,12,2715.01,2,4,4,10
13737.0,0.0,1,339.59999999999997,4,1,2,7
13738.0,487.0,1,440.93,1,1,2,4
13739.0,0.0,2,292.2,4,1,1,6
13740.0,371.0,5,1597.77,1,3,3,7
13741.0,5.0,4,666.33,3,2,2,7
13742.0,32.0,14,3102.42,3,4,4,11
13743.0,2.0,8,1340.1499999999999,3,3,3,9
13744.0,216.0,2,1156.36,2,1,3,6
13745.0,34.0,4,761.27,3,2,2,7
13746.0,0.0,1,176.69,4,1,1,6
13747.0,396.0,2,249.39999999999998,1,1,1,3
13748.0,160.0,9,2268.35,2,4,4,10
13749.0,528.0,1,-10.25,1,1,1,3
13750.0,163.0,13,3563.6,2,4,4,10
13751.0,0.0,1,296.25,4,1,1,6
13752.0,97.0,7,1590.73,3,3,3,9
13753.0,1004.0,4,2094.57,1,2,3,6
13754.0,34.0,3,447.05,3,2,2,7
13755.0,154.0,10,2154.68,2,4,3,9
13756.0,62.0,25,9147.2,3,4,4,11
13757.0,649.0,1,195.55,1,1,1,3
13758.0,101.0,19,9263.14,2,4,4,10
13759.0,183.0,2,659.4100000000001,2,1,2,5
13760.0,585.0,6,1358.6399999999999,1,3,3,7
13761.0,0.0,6,1952.17,4,3,3,10
13762.0,220.0,6,2165.76,2,3,3,8
13763.0,154.0,6,5181.99,2,3,4,9
13764.0,193.0,6,2953.26,2,3,4,9
13765.0,0.0,1,352.821,4,1,2,7
13766.0,702.0,1,190.35,1,1,1,3
13767.0,34.0,96,35115.68,3,4,4,11
13768.0,528.0,8,758.07,1,3,2,6
13769.0,61.0,29,5766.63,3,4,4,11
13770.0,617.0,4,785.37,1,2,2,5
13771.0,184.0,10,5726.07,2,4,4,10
13772.0,183.0,9,3094.72,2,4,4,10
13773.0,487.0,2,301.54,1,1,1,3
13774.0,0.0,1,345.0,4,1,2,7
13775.0,0.0,1,1049.66,4,1,3,8
13776.0,519.0,8,-340.17,1,3,1,5
13777.0,90.0,73,56016.57,3,4,4,11
13778.0,582.0,5,1116.54,1,3,3,7
13779.0,369.0,1,161.13,1,1,1,3
13780.0,302.0,3,735.82,2,2,2,6
13781.0,282.0,4,770.88,2,2,2,6
13782.0,156.0,14,1785.77,2,4,3,9
13783.0,434.0,4,1542.09,1,2,3,6
13784.0,40.0,15,2897.18,3,4,4,11
13785.0,519.0,4,542.49,1,2,2,5
13786.0,402.0,8,2736.41,1,3,4,8
13787.0,425.0,9,1173.7,1,4,3,8
13788.0,0.0,1,3.75,4,1,1,6
13789.0,0.0,1,239.45999999999998,4,1,1,6
13790.0,213.0,1,348.8,2,1,2,5
13791.0,247.0,3,1047.68,2,2,3,7
13792.0,245.0,3,383.95,2,2,2,6
13793.0,648.0,1,96.0,1,1,1,3
13794.0,400.0,1,126.03,1,1,1,3
13795.0,373.0,4,836.3,1,2,2,5
13796.0,0.0,1,289.7,4,1,1,6
13797.0,648.0,4,1168.45,1,2,3,6
13798.0,2.0,125,73573.47,3,4,4,11
13799.0,402.0,13,2039.82,1,4,3,8
13800.0,284.0,3,1679.56,2,2,3,7
13801.0,245.0,1,324.8,2,1,1,4
13802.0,343.0,24,25491.56,2,4,4,10
13803.0,555.0,4,1319.1100000000001,1,2,3,6
13804.0,91.0,9,3208.52,3,4,4,11
13805.0,306.0,2,924.6,2,1,3,6
13806.0,154.0,1,256.38,2,1,1,4
13807.0,517.0,4,509.9,1,2,2,5
13808.0,155.0,5,1747.66,2,3,3,8
13809.0,162.0,3,679.7,2,2,2,6
13810.0,30.0,4,899.51,3,2,3,8
13811.0,96.0,4,591.75,3,2,2,7
13812.0,184.0,3,539.0,2,2,2,6
13813.0,32.0,12,2686.42,3,4,4,11
13814.0,124.0,5,2239.07,2,3,4,9
13815.0,374.0,10,7285.79,1,4,4,9
13816.0,184.0,4,555.04,2,2,2,6
13817.0,60.0,2,382.98,3,1,2,6
13818.0,549.0,1,61.28,1,1,1,3
13819.0,39.0,7,2631.1,3,3,4,10
13820.0,648.0,5,640.4,1,3,2,6
13821.0,365.0,7,1387.03,2,3,3,8
13822.0,243.0,2,632.0,2,1,2,5
13823.0,93.0,8,3358.55,3,3,4,10
13824.0,7.0,14,3273.36,3,4,4,11
13825.0,820.0,2,255.59,1,1,1,3
13826.0,248.0,2,174.65,2,1,1,4
13827.0,0.0,3,412.05,4,2,2,8
13828.0,0.0,1,209.49,4,1,1,6
13829.0,0.0,2,0.0,4,1,1,6
13830.0,524.0,2,135.95000000000002,1,1,1,3
13831.0,220.0,20,7009.18,2,4,4,10
13832.0,0.0,3,602.4399999999999,4,2,2,8
13833.0,279.0,2,701.36,2,1,2,5
13834.0,371.0,3,247.89,1,2,1,4
13835.0,128.0,8,1044.82,2,3,3,8
13836.0,579.0,3,602.52,1,2,2,5
13837.0,6.0,2,271.24,3,1,1,5
13838.0,243.0,10,1966.09,2,4,3,9
13839.0,429.0,1,139.95000000000002,1,1,1,3
13840.0,0.0,1,651.4,4,1,2,7
13841.0,341.0,1,85.0,2,1,1,4
13842.0,1.0,19,5604.96,3,4,4,11
13843.0,0.0,1,319.75,4,1,1,6
13844.0,0.0,1,361.62,4,1,2,7
13845.0,184.0,1,312.98,2,1,1,4
13846.0,37.0,5,1290.34,3,3,3,9
13847.0,0.0,1,310.72,4,1,1,6
13848.0,124.0,8,3335.0,2,3,4,9
13849.0,366.0,6,3443.8,1,3,4,8
13850.0,1.0,2,1586.81,3,1,3,7
13851.0,216.0,9,4516.76,2,4,4,10
13852.0,372.0,2,170.45000000000002,1,1,1,3
13853.0,333.0,2,1056.94,2,1,3,6
13854.0,2.0,45,12158.21,3,4,4,11
13855.0,528.0,5,1253.94,1,3,3,7
13856.0,96.0,15,1058.88,3,4,3,10
13857.0,395.0,7,997.11,1,3,3,7
13858.0,0.0,1,216.17,4,1,1,6
13859.0,0.0,2,515.86,4,1,2,7
13860.0,121.0,6,1240.0,2,3,3,8
13861.0,549.0,3,251.31,1,2,1,4
13862.0,40.0,11,2534.04,3,4,4,11
13863.0,129.0,6,1217.63,2,3,3,8
13864.0,0.0,1,662.4000000000001,4,1,2,7
13865.0,1.0,4,501.56,3,2,2,7
13866.0,0.0,1,145.67000000000002,4,1,1,6
13867.0,122.0,3,1015.29,2,2,3,7
13868.0,302.0,2,3192.54,2,1,4,7
13869.0,125.0,10,8111.57,2,4,4,10
13870.0,152.0,18,5689.84,2,4,4,10
13871.0,69.0,21,7804.95,3,4,4,11
13872.0,850.0,6,891.32,1,3,3,7
13873.0,3.0,9,1031.02,3,4,3,10
13874.0,464.0,10,1989.2,1,4,3,8
13875.0,39.0,14,4814.37,3,4,4,11
13876.0,154.0,1,122.7,2,1,1,4
13877.0,491.0,5,446.33,1,3,2,6
13878.0,431.0,4,2473.06,1,2,4,7
13879.0,617.0,1,395.5,1,1,2,4
13880.0,188.0,17,4391.66,2,4,4,10
13881.0,30.0,51,44392.5,3,4,4,11
13882.0,91.0,6,1131.28,3,3,3,9
13883.0,5.0,26,6342.74,3,4,4,11
13884.0,32.0,14,1852.38,3,4,3,10
13885.0,280.0,2,506.8,2,1,2,5
13886.0,0.0,1,243.56,4,1,1,6
13887.0,0.0,1,349.55,4,1,2,7
13888.0,3.0,7,2169.05,3,3,3,9
13889.0,124.0,8,1855.73,2,3,3,8
13890.0,121.0,22,2858.73,2,4,4,10
13891.0,554.0,3,863.5600000000001,1,2,3,6
13892.0,160.0,6,1267.6499999999999,2,3,3,8
13893.0,0.0,1,821.1,4,1,2,7
13894.0,70.0,5,535.97,3,3,2,8
13895.0,30.0,8,3923.62,3,3,4,10
13896.0,0.0,1,388.55,4,1,2,7
13897.0,0.0,3,1160.72,4,2,3,9
13898.0,0.0,2,686.4,4,1,2,7
13899.0,69.0,2,388.52,3,1,2,6
13900.0,95.0,7,1608.09,3,3,3,9
13901.0,248.0,20,5599.34,2,4,4,10
13902.0,851.0,8,30411.26,1,3,4,8
13903.0,608.0,1,165.45000000000002,1,1,1,3
13904.0,303.0,2,332.64,2,1,2,5
13905.0,528.0,3,244.45,1,2,1,4
13906.0,0.0,1,42.0,4,1,1,6
13907.0,0.0,1,136.8,4,1,1,6
13908.0,5.0,5,2347.05,3,3,4,10
13909.0,365.0,2,286.6,2,1,1,4
13910.0,0.0,1,-127.66,4,1,1,6
13911.0,128.0,22,4200.04,2,4,4,10
13912.0,366.0,1,124.95,1,1,1,3
13913.0,0.0,1,42.22,4,1,1,6
13914.0,182.0,3,613.95,2,2,2,6
13915.0,426.0,2,31.200000000000003,1,1,1,3
13916.0,670.0,5,1260.51,1,3,3,7
13917.0,339.0,2,272.04,2,1,1,4
13918.0,0.0,2,1212.8400000000001,4,1,3,8
13919.0,31.0,5,1326.03,3,3,3,9
13920.0,551.0,5,1734.88,1,3,3,7
13921.0,366.0,5,720.75,1,3,2,6
13922.0,579.0,5,824.7,1,3,2,6
13923.0,0.0,1,351.13,4,1,2,7
13924.0,121.0,11,1682.08,2,4,3,9
13925.0,64.0,6,616.65,3,3,2,8
13926.0,0.0,1,223.85000000000002,4,1,1,6
13927.0,0.0,3,689.96,4,2,2,8
13928.0,122.0,4,464.57,2,2,2,6
13929.0,551.0,14,3318.1,1,4,4,9
13930.0,0.0,2,337.34,4,1,2,7
13931.0,216.0,12,5250.78,2,4,4,10
13932.0,0.0,1,307.4,4,1,1,6
13933.0,0.0,2,608.7900000000001,4,1,2,7
13934.0,0.0,1,922.1,4,1,3,8
13935.0,0.0,3,6116.92,4,2,4,10
13936.0,0.0,4,924.36,4,2,3,9
13937.0,487.0,3,867.38,1,2,3,6
13938.0,244.0,1,71.66,2,1,1,4
13939.0,312.0,10,1533.66,2,4,3,9
13940.0,184.0,4,839.14,2,2,2,6
13941.0,32.0,17,10846.15,3,4,4,11
13942.0,0.0,1,320.0,4,1,1,6
13943.0,401.0,1,246.54,1,1,1,3
13944.0,0.0,1,200.43,4,1,1,6
13945.0,426.0,2,854.15,1,1,3,5
13946.0,973.0,7,1745.43,1,3,3,7
13947.0,215.0,1,90.6,2,1,1,4
13948.0,617.0,5,536.86,1,3,2,6
13949.0,152.0,6,2427.32,2,3,4,9
13950.0,160.0,5,728.56,2,3,2,7
13951.0,0.0,3,674.45,4,2,2,8
13952.0,5.0,17,12790.891,3,4,4,11
13953.0,69.0,12,6640.68,3,4,4,11
13954.0,121.0,3,378.59,2,2,2,6
13955.0,126.0,3,545.17,2,2,2,6
13956.0,68.0,5,1026.42,3,3,3,9
13957.0,0.0,3,458.25,4,2,2,8
13958.0,526.0,12,4402.33,1,4,4,9
13959.0,282.0,6,1076.18,2,3,3,8
13960.0,0.0,2,230.22,4,1,1,6
13961.0,365.0,2,498.7,2,1,2,5
13962.0,129.0,3,362.8,2,2,2,6
13963.0,253.0,18,2899.62,2,4,4,10
13964.0,519.0,3,421.9,1,2,2,5
13965.0,428.0,5,777.6600000000001,1,3,2,6
13966.0,0.0,1,390.86,4,1,2,7
13967.0,487.0,2,166.3,1,1,1,3
13968.0,366.0,1,123.66,1,1,1,3
13969.0,31.0,39,13212.77,3,4,4,11
13970.0,0.0,2,846.55,4,1,3,8
13971.0,5.0,18,4593.83,3,4,4,11
13972.0,0.0,2,190.25,4,1,1,6
13973.0,0.0,1,264.7,4,1,1,6
13974.0,401.0,4,663.52,1,2,2,5
13975.0,38.0,14,5327.29,3,4,4,11
13976.0,465.0,4,1192.36,1,2,3,6
13977.0,0.0,1,519.8100000000001,4,1,2,7
13978.0,0.0,2,196.79000000000002,4,1,1,6
13979.0,371.0,11,3326.83,1,4,4,9
13980.0,62.0,9,753.12,3,4,2,9
13981.0,609.0,2,327.39,1,1,2,4
13982.0,455.0,13,4418.79,1,4,4,9
13983.0,1.0,30,6993.41,3,4,4,11
13984.0,157.0,13,1616.1200000000001,2,4,3,9
13985.0,1.0,24,9982.31,3,4,4,11
13986.0,0.0,1,320.46,4,1,1,6
13987.0,609.0,2,682.54,1,1,2,4
13988.0,61.0,11,4708.64,3,4,4,11
13989.0,215.0,5,2026.06,2,3,3,8
13990.0,67.0,1,311.3,3,1,1,5
13991.0,0.0,7,850.63,4,3,3,10
13992.0,91.0,3,219.5,3,2,1,6
13993.0,32.0,24,6690.36,3,4,4,11
13994.0,182.0,6,2313.14,2,3,4,9
13995.0,37.0,18,3836.26,3,4,4,11
13996.0,579.0,2,895.76,1,1,3,5
13997.0,490.0,3,382.31,1,2,2,5
13998.0,371.0,3,566.7,1,2,2,5
13999.0,30.0,36,9438.01,3,4,4,11
14000.0,6.0,8,1877.5900000000001,3,3,3,9
14001.0,579.0,10,4517.34,1,4,4,9
14002.0,187.0,2,529.73,2,1,2,5
14003.0,882.0,1,209.41,1,1,1,3
14004.0,246.0,11,6258.45,2,4,4,10
14005.0,128.0,5,2874.72,2,3,4,9
14006.0,7.0,7,2196.67,3,3,4,10
14007.0,0.0,1,79.48,4,1,1,6
14008.0,641.0,2,493.74,1,1,2,4
14009.0,642.0,4,1090.23,1,2,3,6
14010.0,0.0,3,288.09999999999997,4,2,1,7
14011.0,402.0,3,451.91999999999996,1,2,2,5
14012.0,161.0,1,328.8,2,1,2,5
14013.0,99.0,6,1006.22,3,3,3,9
14014.0,371.0,3,1948.21,1,2,3,6
14015.0,0.0,1,917.34,4,1,3,8
14016.0,126.0,13,11379.71,2,4,4,10
14017.0,0.0,1,229.75,4,1,1,6
14018.0,617.0,1,367.15000000000003,1,1,2,4
14019.0,305.0,4,1398.96,2,2,3,7
14020.0,2.0,5,1213.26,3,3,3,9
14021.0,6.0,7,1716.58,3,3,3,9
14022.0,429.0,2,792.15,1,1,2,4
14023.0,282.0,2,584.07,2,1,2,5
14024.0,64.0,3,645.74,3,2,2,7
14025.0,371.0,10,3969.1,1,4,4,9
14026.0,0.0,2,713.11,4,1,2,7
14027.0,62.0,1,104.82,3,1,1,5
14028.0,523.0,5,3175.5,1,3,4,8
14029.0,154.0,2,467.66,2,1,2,5
14030.0,32.0,22,8145.59,3,4,4,11
14031.0,39.0,55,38025.97,3,4,4,11
14032.0,7.0,25,4786.07,3,4,4,11
14033.0,673.0,1,109.44,1,1,1,3
14034.0,218.0,4,512.02,2,2,2,6
14035.0,30.0,11,2852.47,3,4,4,11
14036.0,0.0,1,626.65,4,1,2,7
14037.0,425.0,7,755.95,1,3,2,6
14038.0,518.0,8,3000.93,1,3,4,8
14039.0,183.0,2,267.28000000000003,2,1,1,4
14040.0,10.0,42,12457.84,3,4,4,11
14041.0,0.0,1,141.41,4,1,1,6
14042.0,0.0,1,431.98,4,1,2,7
14043.0,581.0,3,301.3,1,2,1,4
14044.0,284.0,11,3106.15,2,4,4,10
14045.0,193.0,19,9660.63,2,4,4,10
14046.0,0.0,1,154.99,4,1,1,6
14047.0,163.0,19,4158.7300000000005,2,4,4,10
14048.0,161.0,4,713.89,2,2,2,6
14049.0,248.0,18,13064.03,2,4,4,10
14050.0,122.0,2,746.36,2,1,2,5
14051.0,31.0,42,22104.5,3,4,4,11
14052.0,0.0,2,480.81,4,1,2,7
14053.0,156.0,4,572.3,2,2,2,6
14054.0,215.0,1,92.46,2,1,1,4
14055.0,401.0,3,1520.96,1,2,3,6
14056.0,36.0,29,8124.4,3,4,4,11
14057.0,32.0,23,8338.28,3,4,4,11
14058.0,642.0,2,469.19,1,1,2,4
14059.0,0.0,1,183.6,4,1,1,6
14060.0,71.0,32,9503.14,3,4,4,11
14061.0,1062.0,3,917.4300000000001,1,2,3,6
14062.0,93.0,27,25434.83,3,4,4,11
14063.0,497.0,13,-3767.1999999999994,1,4,1,6
14064.0,6.0,21,3039.75,3,4,4,11
14065.0,610.0,4,889.37,1,2,3,6
14066.0,0.0,1,152.55,4,1,1,6
14067.0,154.0,2,374.7,2,1,2,5
14068.0,0.0,5,1504.97,4,3,3,10
14069.0,0.0,2,230.06,4,1,1,6
14070.0,0.0,1,326.55,4,1,2,7
14071.0,7.0,9,1307.41,3,4,3,10
14072.0,404.0,1,390.85,1,1,2,4
14073.0,153.0,2,139.54,2,1,1,4
14074.0,0.0,1,219.39999999999998,4,1,1,6
14075.0,213.0,6,1734.87,2,3,3,8
14076.0,306.0,1,122.47,2,1,1,4
14077.0,66.0,6,615.0799999999999,3,3,2,8
14078.0,67.0,9,1692.6299999999999,3,4,3,10
14079.0,156.0,2,618.73,2,1,2,5
14080.0,153.0,6,1075.73,2,3,3,8
14081.0,70.0,16,5250.05,3,4,4,11
14082.0,365.0,2,413.36,2,1,2,5
14083.0,38.0,11,1407.26,3,4,3,10
14084.0,0.0,1,150.5,4,1,1,6
14085.0,99.0,34,10092.22,3,4,4,11
14086.0,642.0,1,39.95,1,1,1,3
14087.0,152.0,5,803.47,2,3,2,7
14088.0,278.0,20,62400.02,2,4,4,10
14089.0,0.0,1,161.0,4,1,1,6
14090.0,0.0,1,76.32000000000001,4,1,1,6
14091.0,436.0,2,9530.08,1,1,4,6
14092.0,183.0,27,7209.74,2,4,4,10
14093.0,0.0,1,442.85,4,1,2,7
14094.0,0.0,2,334.27,4,1,2,7
14095.0,0.0,1,2.95,4,1,1,6
14096.0,61.0,34,57120.909999999996,3,4,4,11
14097.0,617.0,2,422.85999999999996,1,1,2,4
14098.0,275.0,1,147.35,2,1,1,4
14099.0,33.0,22,5700.51,3,4,4,11
14100.0,0.0,1,194.9,4,1,1,6
14101.0,372.0,14,9942.13,1,4,4,9
14102.0,243.0,8,1314.73,2,3,3,8
14103.0,374.0,1,0.0,1,1,1,3
14104.0,126.0,5,771.5799999999999,2,3,2,7
14105.0,426.0,9,5703.9800000000005,1,4,4,9
14106.0,1032.0,1,214.79999999999998,1,1,1,3
14107.0,246.0,13,4853.7,2,4,4,10
14108.0,91.0,5,1041.21,3,3,3,9
14109.0,0.0,2,80.2,4,1,1,6
14110.0,2.0,35,12957.6,3,4,4,11
14111.0,7.0,5,688.6,3,3,2,8
14112.0,94.0,27,5524.51,3,4,4,11
14113.0,182.0,31,6156.75,2,4,4,10
14114.0,38.0,7,1364.09,3,3,3,9
14115.0,404.0,2,622.6700000000001,1,1,2,4
14116.0,64.0,5,1382.74,3,3,3,9
14117.0,0.0,1,90.0,4,1,1,6
14118.0,519.0,1,458.45,1,1,2,4
14119.0,0.0,3,163.47,4,2,1,7
14120.0,579.0,1,-23.8,1,1,1,3
14121.0,31.0,6,2740.3,3,3,4,10
14122.0,426.0,5,309.77,1,3,1,5
14123.0,912.0,1,436.18,1,1,2,4
14124.0,0.0,1,419.58000000000004,4,1,2,7
14125.0,30.0,3,2740.43,3,2,4,9
14126.0,302.0,5,1109.96,2,3,3,8
14127.0,94.0,6,1900.0800000000002,3,3,3,9
14128.0,62.0,4,909.36,3,2,3,8
14129.0,121.0,9,2591.34,2,4,4,10
14130.0,759.0,4,1882.67,1,2,3,6
14131.0,707.0,1,187.87,1,1,1,3
14132.0,4.0,12,3580.13,3,4,4,11
14133.0,39.0,6,895.8399999999999,3,3,3,9
14134.0,492.0,15,11123.35,1,4,4,9
14135.0,40.0,25,9605.05,3,4,4,11
14136.0,587.0,7,1553.96,1,3,3,7
14137.0,0.0,2,294.1,4,1,1,6
14138.0,121.0,2,982.3800000000001,2,1,3,6
14139.0,551.0,4,1086.8,1,2,3,6
14140.0,122.0,3,920.05,2,2,3,7
14141.0,31.0,6,879.0300000000001,3,3,3,9
14142.0,398.0,4,967.75,1,2,3,6
14143.0,0.0,1,115.8,4,1,1,6
14144.0,429.0,1,30.599999999999998,1,1,1,3
14145.0,187.0,8,7006.05,2,3,4,9
14146.0,333.0,13,8208.87,2,4,4,10
14147.0,432.0,12,2019.3,1,4,3,8
14148.0,0.0,2,466.29,4,1,2,7
14149.0,36.0,3,259.43,3,2,1,6
14150.0,244.0,2,658.64,2,1,2,5
14151.0,618.0,3,666.7,1,2,2,5
14152.0,458.0,9,1975.44,1,4,3,8
14153.0,0.0,1,233.4,4,1,1,6
14154.0,366.0,10,6263.6,1,4,4,9
14155.0,0.0,1,118.75,4,1,1,6
14156.0,1.0,202,296564.69,3,4,4,11
14157.0,648.0,6,970.33,1,3,3,7
14158.0,0.0,1,507.66,4,1,2,7
14159.0,216.0,25,7571.88,2,4,4,10
14160.0,436.0,7,8421.47,1,3,4,8
14161.0,128.0,7,3318.88,2,3,4,9
14162.0,0.0,2,289.36,4,1,1,6
14163.0,65.0,5,2594.62,3,3,4,10
14164.0,0.0,2,1631.77,4,1,3,8
14165.0,99.0,1,122.53999999999999,3,1,1,5
14166.0,0.0,2,256.85,4,1,1,6
14167.0,10.0,8,1296.49,3,3,3,9
14168.0,431.0,3,305.9,1,2,1,4
14169.0,580.0,2,624.4300000000001,1,1,2,4
14170.0,456.0,3,597.33,1,2,2,5
14171.0,305.0,2,498.79,2,1,2,5
14172.0,403.0,4,389.97,1,2,2,5
14173.0,250.0,7,566.95,2,3,2,7
14174.0,183.0,1,134.46,2,1,1,4
14175.0,31.0,17,7350.44,3,4,4,11
14176.0,517.0,6,913.11,1,3,3,7
14177.0,216.0,14,2224.39,2,4,4,10
14178.0,30.0,7,1620.93,3,3,3,9
14179.0,0.0,2,719.78,4,1,2,7
14180.0,36.0,42,6110.75,3,4,4,11
14181.0,0.0,2,310.55,4,1,1,6
14182.0,432.0,5,660.07,1,3,2,6
14183.0,0.0,2,286.29,4,1,1,6
14184.0,245.0,1,452.89,2,1,2,5
14185.0,10.0,1,197.65,3,1,1,5
14186.0,488.0,5,1550.63,1,3,3,7
14187.0,0.0,1,123.5,4,1,1,6
14188.0,91.0,10,2018.91,3,4,3,10
14189.0,61.0,25,5764.62,3,4,4,11
14190.0,404.0,1,79.9,1,1,1,3
14191.0,64.0,17,4713.41,3,4,4,11
14192.0,0.0,1,293.74,4,1,1,6
14193.0,276.0,3,1210.19,2,2,3,7
14194.0,31.0,54,18442.87,3,4,4,11
14195.0,341.0,10,2381.24,2,4,4,10
14196.0,0.0,1,335.52,4,1,2,7
14197.0,0.0,1,390.05,4,1,2,7
14198.0,213.0,13,1527.58,2,4,3,9
14199.0,220.0,6,916.4999999999999,2,3,3,8
14200.0,706.0,1,379.2,1,1,2,4
14201.0,5.0,12,1134.14,3,4,3,10
14202.0,704.0,3,847.76,1,2,3,6
14203.0,518.0,1,339.34,1,1,2,4
14204.0,152.0,4,1062.96,2,2,3,7
14205.0,426.0,12,1908.38,1,4,3,8
14206.0,668.0,5,1145.21,1,3,3,7
14207.0,0.0,1,157.8,4,1,1,6
14208.0,185.0,2,567.05,2,1,2,5
14209.0,40.0,19,4937.37,3,4,4,11
14210.0,93.0,21,5814.320000000001,3,4,4,11
14211.0,69.0,26,4301.69,3,4,4,11
14212.0,32.0,2,2190.14,3,1,4,8
14213.0,639.0,2,-1192.2,1,1,1,3
14214.0,38.0,7,1000.23,3,3,3,9
14215.0,188.0,10,3404.53,2,4,4,10
14216.0,182.0,6,2142.39,2,3,3,8
14217.0,40.0,33,3206.87,3,4,4,11
14218.0,0.0,1,169.48000000000002,4,1,1,6
14219.0,213.0,3,633.83,2,2,2,6
14220.0,190.0,4,1515.0,2,2,3,7
14221.0,127.0,19,6506.59,2,4,4,10
14222.0,0.0,1,683.17,4,1,2,7
14223.0,124.0,4,975.23,2,2,3,7
14224.0,128.0,9,1897.9,2,4,3,9
14225.0,375.0,5,2015.12,1,3,3,7
14226.0,30.0,9,2967.78,3,4,4,11
14227.0,69.0,22,6327.31,3,4,4,11
14228.0,400.0,3,745.5,1,2,2,5
14229.0,71.0,11,2468.99,3,4,4,11
14230.0,461.0,3,979.8000000000001,1,2,3,6
14231.0,96.0,6,1131.97,3,3,3,9
14232.0,95.0,8,2043.93,3,3,3,9
14233.0,6.0,10,2766.96,3,4,4,11
14234.0,91.0,4,775.46,3,2,2,7
14235.0,218.0,10,4666.99,2,4,4,10
14236.0,487.0,7,1732.74,1,3,3,7
14237.0,698.0,3,627.04,1,2,2,5
14238.0,943.0,3,434.23,1,2,2,5
14239.0,160.0,24,4203.72,2,4,4,10
14240.0,91.0,3,1247.49,3,2,3,8
14241.0,96.0,2,333.70000000000005,3,1,2,6
14242.0,0.0,2,280.55,4,1,1,6
14243.0,93.0,23,7365.36,3,4,4,11
14244.0,0.0,2,354.82,4,1,2,7
14245.0,250.0,5,1677.48,2,3,3,8
14246.0,129.0,3,1474.06,2,2,3,7
14247.0,191.0,6,769.71,2,3,2,7
14248.0,369.0,3,1032.95,1,2,3,6
14249.0,553.0,12,5625.461,1,4,4,9
14250.0,32.0,3,1904.05,3,2,3,8
14251.0,121.0,5,2879.7000000000003,2,3,4,9
14252.0,0.0,1,350.99,4,1,2,7
14253.0,643.0,2,363.40000000000003,1,1,2,4
14254.0,641.0,1,601.03,1,1,2,4
14255.0,400.0,4,-1441.6,1,2,1,4
14256.0,425.0,9,2397.34,1,4,4,9
14257.0,125.0,10,5942.0,2,4,4,10
14258.0,32.0,32,31027.35,3,4,4,11
14259.0,0.0,1,120.0,4,1,1,6
14260.0,461.0,3,824.28,1,2,2,5
14261.0,0.0,2,1163.45,4,1,3,8
14262.0,61.0,8,2618.23,3,3,4,10
14263.0,366.0,1,322.93,1,1,1,3
14264.0,126.0,8,1461.3600000000001,2,3,3,8
14265.0,555.0,4,1373.35,1,2,3,6
14266.0,519.0,1,40.56,1,1,1,3
14267.0,4.0,9,1259.19,3,4,3,10
14268.0,0.0,1,354.85,4,1,2,7
14269.0,0.0,2,261.68,4,1,1,6
14270.0,10.0,1,492.65000000000003,3,1,2,6
14271.0,0.0,2,219.13,4,1,1,6
14272.0,554.0,4,920.81,1,2,3,6
14273.0,37.0,4,559.97,3,2,2,7
14274.0,0.0,1,256.6,4,1,1,6
14275.0,402.0,6,1189.3799999999999,1,3,3,7
14276.0,1.0,13,1929.32,3,4,3,10
14277.0,36.0,14,4324.47,3,4,4,11
14278.0,0.0,1,205.83,4,1,1,6
14279.0,522.0,2,191.86,1,1,1,3
14280.0,0.0,1,134.04,4,1,1,6
14281.0,0.0,1,245.15,4,1,1,6
14282.0,122.0,26,7844.66,2,4,4,10
14283.0,670.0,4,628.4399999999999,1,2,2,5
14284.0,91.0,4,1282.85,3,2,3,8
14285.0,303.0,9,3158.64,2,4,4,10
14286.0,2.0,12,8396.7,3,4,4,11
14287.0,66.0,4,151.23000000000002,3,2,1,6
14288.0,36.0,2,413.85,3,1,2,6
14289.0,7.0,6,911.26,3,3,3,9
14290.0,276.0,14,4208.93,2,4,4,10
14291.0,33.0,25,7844.4,3,4,4,11
14292.0,2.0,27,8887.9,3,4,4,11
14293.0,162.0,10,3174.33,2,4,4,10
14294.0,0.0,1,375.34,4,1,2,7
14295.0,40.0,8,2316.06,3,3,4,10
14296.0,0.0,3,448.45,4,2,2,8
14297.0,62.0,6,1284.06,3,3,3,9
14298.0,91.0,84,90489.31,3,4,4,11
14299.0,1.0,41,12827.77,3,4,4,11
14300.0,0.0,1,43.2,4,1,1,6
14301.0,404.0,7,1956.23,1,3,3,7
14302.0,580.0,3,742.9000000000001,1,2,2,5
14303.0,700.0,2,277.94,1,1,1,3
14304.0,39.0,5,1523.81,3,3,3,9
14305.0,33.0,5,1803.76,3,3,3,9
14306.0,0.0,7,3141.5,4,3,4,11
14307.0,2.0,11,5063.08,3,4,4,11
14308.0,492.0,5,-849.45,1,3,1,5
14309.0,30.0,12,3747.96,3,4,4,11
14310.0,641.0,1,492.1,1,1,2,4
14311.0,37.0,3,435.90000000000003,3,2,2,7
14312.0,38.0,11,3090.29,3,4,4,11
14313.0,0.0,1,-302.31,4,1,1,6
14314.0,580.0,3,221.9,1,2,1,4
14315.0,126.0,10,3168.72,2,4,4,10
14316.0,431.0,6,1355.34,1,3,3,7
14317.0,184.0,1,508.58000000000004,2,1,2,5
14318.0,581.0,1,158.02,1,1,1,3
14319.0,396.0,2,476.95000000000005,1,1,2,4
14320.0,40.0,7,1204.1200000000001,3,3,3,9
14321.0,71.0,8,2198.58,3,3,4,10
14322.0,373.0,6,384.3,1,3,2,6
14323.0,308.0,4,574.26,2,2,2,6
14324.0,0.0,2,701.61,4,1,2,7
14325.0,0.0,1,245.48000000000002,4,1,1,6
14326.0,37.0,4,923.98,3,2,3,8
14327.0,497.0,6,1894.93,1,3,3,7
14328.0,458.0,3,-445.06,1,2,1,4
14329.0,38.0,28,9735.52,3,4,4,11
14330.0,0.0,1,200.63,4,1,1,6
14331.0,156.0,2,462.65999999999997,2,1,2,5
14332.0,245.0,5,1943.51,2,3,3,8
14333.0,183.0,2,351.45,2,1,2,5
14334.0,69.0,14,4292.98,3,4,4,11
14335.0,246.0,2,468.26,2,1,2,5
14336.0,130.0,4,1614.91,2,2,3,7
14337.0,851.0,1,-658.63,1,1,1,3
14338.0,248.0,5,894.1,2,3,3,8
14339.0,37.0,5,600.66,3,3,2,8
14340.0,220.0,1,134.7,2,1,1,4
14341.0,128.0,20,4443.47,2,4,4,10
14342.0,122.0,9,842.74,2,4,2,8
14343.0,0.0,4,1088.91,4,2,3,9
14344.0,99.0,20,3333.7000000000003,3,4,4,11
14345.0,334.0,1,108.97999999999999,2,1,1,4
14346.0,33.0,5,2315.75,3,3,4,10
14347.0,1004.0,1,82.6,1,1,1,3
14348.0,0.0,1,409.57,4,1,2,7
14349.0,0.0,1,133.5,4,1,1,6
14350.0,69.0,4,947.8,3,2,3,8
14351.0,0.0,1,51.0,4,1,1,6
14352.0,38.0,4,1078.96,3,2,3,8
14353.0,128.0,3,376.5,2,2,2,6
14354.0,91.0,2,163.62,3,1,1,5
14355.0,455.0,3,1014.45,1,2,3,6
14356.0,62.0,4,666.9399999999999,3,2,2,7
14357.0,0.0,1,225.77,4,1,1,6
14358.0,518.0,3,384.29999999999995,1,2,2,5
14359.0,244.0,6,882.58,2,3,3,8
14360.0,122.0,4,2128.23,2,2,3,7
14361.0,432.0,1,214.70999999999998,1,1,1,3
14362.0,0.0,1,161.2,4,1,1,6
14363.0,668.0,2,227.47000000000003,1,1,1,3
14364.0,6.0,8,3717.35,3,3,4,10
14365.0,426.0,2,634.68,1,1,2,4
14366.0,671.0,1,136.0,1,1,1,3
14367.0,34.0,19,9167.82,3,4,4,11
14368.0,0.0,1,155.0,4,1,1,6
14369.0,526.0,2,469.13,1,1,2,4
14370.0,368.0,9,1092.13,1,4,3,8
14371.0,0.0,1,100.5,4,1,1,6
14372.0,0.0,3,830.1800000000001,4,2,2,8
14373.0,0.0,1,76.55,4,1,1,6
14374.0,0.0,1,108.0,4,1,1,6
14375.0,158.0,3,1132.99,2,2,3,7
14376.0,0.0,1,215.46,4,1,1,6
14377.0,339.0,2,617.05,2,1,2,5
14378.0,0.0,1,131.25,4,1,1,6
14379.0,395.0,4,1268.91,1,2,3,6
14380.0,0.0,2,-99.72999999999999,4,1,1,6
14381.0,0.0,2,631.34,4,1,2,7
14382.0,0.0,3,1240.85,4,2,3,9
14383.0,184.0,3,1247.69,2,2,3,7
14384.0,0.0,1,58.5,4,1,1,6
14385.0,0.0,3,202.11,4,2,1,7
14386.0,0.0,1,142.4,4,1,1,6
14387.0,153.0,3,1770.56,2,2,3,7
14388.0,64.0,20,6589.3,3,4,4,11
14389.0,34.0,11,1821.07,3,4,3,10
14390.0,6.0,18,6323.33,3,4,4,11
14391.0,371.0,1,135.6,1,1,1,3
14392.0,641.0,1,266.4,1,1,1,3
14393.0,219.0,1,67.95,2,1,1,4
14394.0,0.0,1,93.8,4,1,1,6
14395.0,61.0,24,8160.81,3,4,4,11
14396.0,215.0,7,2121.93,2,3,3,8
14397.0,5.0,23,2556.68,3,4,4,11
14398.0,640.0,2,707.79,1,1,2,4
14399.0,426.0,9,2098.16,1,4,3,8
14400.0,609.0,5,1703.0,1,3,3,7
14401.0,61.0,25,6703.4,3,4,4,11
14402.0,0.0,1,285.6,4,1,1,6
14403.0,189.0,9,1822.76,2,4,3,9
14404.0,183.0,15,2800.11,2,4,4,10
14405.0,0.0,1,195.0,4,1,1,6
14406.0,3.0,1,156.75,3,1,1,5
14407.0,130.0,9,2111.08,2,4,3,9
14408.0,185.0,11,4109.77,2,4,4,10
14409.0,94.0,10,3453.69,3,4,4,11
14410.0,124.0,17,2122.37,2,4,3,9
14411.0,312.0,1,1063.0,2,1,3,6
14412.0,244.0,4,1417.49,2,2,3,7
14413.0,364.0,4,770.37,2,2,2,6
14414.0,93.0,9,2387.48,3,4,4,11
14415.0,66.0,32,11915.13,3,4,4,11
14416.0,0.0,2,490.22,4,1,2,7
14417.0,0.0,1,604.2,4,1,2,7
14418.0,182.0,3,1937.25,2,2,3,7
14419.0,62.0,7,1260.91,3,3,3,9
14420.0,335.0,7,1627.72,2,3,3,8
14421.0,6.0,7,2456.62,3,3,4,10
14422.0,90.0,21,10200.92,3,4,4,11
14423.0,220.0,4,914.9599999999999,2,2,3,7
14424.0,0.0,1,322.08,4,1,1,6
14425.0,488.0,5,635.89,1,3,2,6
14426.0,130.0,27,11103.97,2,4,4,10
14427.0,154.0,4,1263.52,2,2,3,7
14428.0,275.0,7,1230.14,2,3,3,8
14429.0,699.0,1,516.28,1,1,2,4
14430.0,402.0,5,956.4000000000001,1,3,3,7
14431.0,70.0,5,2541.6,3,3,4,10
14432.0,32.0,6,2255.51,3,3,4,10
14433.0,0.0,1,289.6,4,1,1,6
14434.0,62.0,6,1372.8,3,3,3,9
14435.0,0.0,1,90.42,4,1,1,6
14436.0,305.0,2,271.70000000000005,2,1,1,4
14437.0,368.0,7,829.94,1,3,2,6
14438.0,192.0,1,131.9,2,1,1,4
14439.0,0.0,5,9443.04,4,3,4,11
14440.0,333.0,15,6526.83,2,4,4,10
14441.0,39.0,19,4361.59,3,4,4,11
14442.0,121.0,12,5272.02,2,4,4,10
14443.0,162.0,8,2351.58,2,3,4,9
14444.0,457.0,1,132.04,1,1,1,3
14445.0,428.0,1,221.65,1,1,1,3
14446.0,30.0,5,1241.31,3,3,3,9
14447.0,252.0,6,1711.73,2,3,3,8
14448.0,424.0,2,375.35,1,1,2,4
14449.0,160.0,8,2482.8,2,3,4,9
14450.0,5.0,7,1128.44,3,3,3,9
14451.0,62.0,18,3265.59,3,4,4,11
14452.0,155.0,4,665.59,2,2,2,6
14453.0,308.0,1,119.93,2,1,1,4
14454.0,527.0,6,970.7,1,3,3,7
14455.0,458.0,5,594.86,1,3,2,6
14456.0,32.0,14,3047.63,3,4,4,11
14457.0,312.0,1,113.64,2,1,1,4
14458.0,0.0,1,237.42,4,1,1,6
14459.0,157.0,3,5339.1410000000005,2,2,4,8
14460.0,312.0,12,919.6,2,4,3,9
14461.0,368.0,14,6697.6,1,4,4,9
14462.0,33.0,16,2231.89,3,4,4,11
14463.0,305.0,4,786.5699999999999,2,2,2,6
14464.0,0.0,2,111.0,4,1,1,6
14465.0,70.0,11,3946.03,3,4,4,11
14466.0,61.0,13,4646.9,3,4,4,11
14467.0,456.0,12,2220.9900000000002,1,4,4,9
14468.0,912.0,1,204.24,1,1,1,3
14469.0,671.0,4,2112.21,1,2,3,6
14470.0,580.0,3,712.04,1,2,2,5
14471.0,882.0,2,400.95,1,1,2,4
14472.0,65.0,9,2228.22,3,4,4,11
14473.0,311.0,2,234.34000000000003,2,1,1,4
14474.0,462.0,3,1268.1299999999999,1,2,3,6
14475.0,70.0,7,1025.1200000000001,3,3,3,9
14476.0,0.0,1,215.7,4,1,1,6
14477.0,127.0,10,1960.61,2,4,3,9
14478.0,429.0,4,1276.66,1,2,3,6
14479.0,455.0,4,1299.11,1,2,3,6
14480.0,528.0,5,1295.27,1,3,3,7
14481.0,555.0,6,1935.32,1,3,3,7
14482.0,91.0,14,4192.25,3,4,4,11
14483.0,283.0,3,249.2,2,2,1,5
14484.0,373.0,4,1070.98,1,2,3,6
14485.0,334.0,1,165.75,2,1,1,4
14486.0,614.0,2,175.5,1,1,1,3
14487.0,32.0,8,1428.11,3,3,3,9
14488.0,276.0,2,1047.43,2,1,3,6
14489.0,555.0,4,1574.93,1,2,3,6
14490.0,519.0,2,1273.47,1,1,3,5
14491.0,667.0,2,468.13,1,1,2,4
14492.0,372.0,10,1574.3600000000001,1,4,3,8
14493.0,91.0,14,5036.05,3,4,4,11
14494.0,640.0,3,401.46,1,2,2,5
14495.0,64.0,4,166.3,3,2,1,6
14496.0,343.0,10,2645.88,2,4,4,10
14497.0,39.0,3,679.16,3,2,2,7
14498.0,188.0,10,3911.27,2,4,4,10
14499.0,191.0,10,2120.62,2,4,3,9
14500.0,2.0,3,356.85,3,2,2,7
14501.0,96.0,3,190.31,3,2,1,6
14502.0,183.0,14,2351.02,2,4,4,10
14503.0,182.0,6,3543.26,2,3,4,9
14504.0,68.0,4,673.26,3,2,2,7
14505.0,67.0,27,11718.8,3,4,4,11
14506.0,245.0,7,3290.67,2,3,4,9
14507.0,128.0,14,3172.4900000000002,2,4,4,10
14508.0,32.0,6,856.09,3,3,3,9
14509.0,0.0,1,110.95,4,1,1,6
14510.0,0.0,4,991.98,4,2,3,9
14511.0,124.0,6,1267.4099999999999,2,3,3,8
14512.0,219.0,7,1223.47,2,3,3,8
14513.0,0.0,7,770.9100000000001,4,3,2,9
14514.0,10.0,10,4594.7300000000005,3,4,4,11
14515.0,220.0,15,3718.9,2,4,4,10
14516.0,399.0,1,163.92,1,1,1,3
14517.0,183.0,2,330.45,2,1,2,5
14518.0,184.0,1,174.37,2,1,1,4
14519.0,759.0,2,206.09,1,1,1,3
14520.0,121.0,2,270.6,2,1,1,4
14521.0,582.0,2,167.65,1,1,1,3
14522.0,124.0,8,1758.6200000000001,2,3,3,8
14523.0,0.0,1,241.09,4,1,1,6
14524.0,122.0,13,2933.71,2,4,4,10
14525.0,32.0,21,8129.8099999999995,3,4,4,11
14526.0,0.0,1,262.4,4,1,1,6
14527.0,1.0,190,25774.54,3,4,4,11
14528.0,303.0,1,364.21999999999997,2,1,2,5
14529.0,62.0,3,620.04,3,2,2,7
14530.0,155.0,19,6077.15,2,4,4,10
14531.0,0.0,1,376.34,4,1,2,7
14532.0,436.0,12,3846.4300000000003,1,4,4,9
14533.0,32.0,15,3185.12,3,4,4,11
14534.0,3.0,38,5786.42,3,4,4,11
14535.0,31.0,11,5872.63,3,4,4,11
14536.0,0.0,1,171.8,4,1,1,6
14537.0,372.0,3,635.45,1,2,2,5
14538.0,184.0,5,1370.8400000000001,2,3,3,8
14539.0,0.0,2,537.48,4,1,2,7
14540.0,284.0,12,3785.44,2,4,4,10
14541.0,1.0,14,2499.68,3,4,4,11
14542.0,158.0,1,103.25,2,1,1,4
14543.0,30.0,50,12194.01,3,4,4,11
14544.0,0.0,3,2982.43,4,2,4,10
14545.0,649.0,1,349.25,1,1,2,4
14546.0,213.0,20,5001.03,2,4,4,10
14547.0,182.0,9,3986.7400000000002,2,4,4,10
14548.0,4.0,9,2627.49,3,4,4,11
14549.0,343.0,4,916.5500000000001,2,2,3,7
14550.0,0.0,4,1353.31,4,2,3,9
14551.0,0.0,9,858.59,4,4,3,11
14552.0,34.0,3,511.28000000000003,3,2,2,7
14553.0,183.0,10,1816.04,2,4,3,9
14554.0,0.0,4,2381.04,4,2,4,10
14555.0,70.0,7,2306.48,3,3,4,10
14556.0,0.0,3,835.34,4,2,2,8
14557.0,183.0,2,0.0,2,1,1,4
14558.0,851.0,5,614.1,1,3,2,6
14559.0,0.0,1,75.6,4,1,1,6
14560.0,60.0,46,6050.44,3,4,4,11
14561.0,127.0,3,1080.76,2,2,3,7
14562.0,61.0,30,6363.85,3,4,4,11
14563.0,0.0,2,679.44,4,1,2,7
14564.0,488.0,5,2519.32,1,3,4,8
14565.0,216.0,7,3833.87,2,3,4,9
14566.0,0.0,4,4092.0,4,2,4,10
14567.0,244.0,3,1524.46,2,2,3,7
14568.0,396.0,2,909.5,1,1,3,5
14569.0,121.0,4,598.98,2,2,2,6
14570.0,252.0,3,613.75,2,2,2,6
14571.0,427.0,1,161.65,1,1,1,3
14572.0,182.0,15,5573.28,2,4,4,10
14573.0,36.0,17,2571.72,3,4,4,11
14574.0,882.0,1,143.70000000000002,1,1,1,3
14575.0,490.0,1,460.71,1,1,2,4
14576.0,666.0,1,70.80000000000001,1,1,1,3
14577.0,364.0,7,1374.25,2,3,3,8
14578.0,182.0,1,168.63,2,1,1,4
14579.0,641.0,1,105.56,1,1,1,3
14580.0,460.0,1,14.850000000000001,1,1,1,3
14581.0,0.0,2,433.8,4,1,2,7
14582.0,0.0,1,114.11,4,1,1,6
14583.0,158.0,8,1781.03,2,3,3,8
14584.0,95.0,9,1734.91,3,4,3,10
14585.0,426.0,5,1143.27,1,3,3,7
14586.0,130.0,3,134.16,2,2,1,5
14587.0,10.0,10,1598.24,3,4,3,10
14588.0,432.0,1,135.39,1,1,1,3
14589.0,639.0,1,79.5,1,1,1,3
14590.0,396.0,28,2884.29,1,4,4,9
14591.0,67.0,4,1447.14,3,2,3,8
14592.0,183.0,3,570.46,2,2,2,6
14593.0,435.0,18,3615.17,1,4,4,9
14594.0,302.0,2,634.83,2,1,2,5
14595.0,92.0,8,2164.45,3,3,3,9
14596.0,0.0,1,229.47,4,1,1,6
14597.0,339.0,6,2201.54,2,3,4,9
14598.0,0.0,3,221.97,4,2,1,7
14599.0,0.0,2,474.54,4,1,2,7
14600.0,162.0,2,865.1700000000001,2,1,3,6
14601.0,0.0,1,213.96,4,1,1,6
14602.0,0.0,1,205.35999999999999,4,1,1,6
14603.0,69.0,1,660.0,3,1,2,6
14604.0,0.0,1,143.85999999999999,4,1,1,6
14605.0,851.0,4,937.16,1,2,3,6
14606.0,6.0,259,30094.38,3,4,4,11
14607.0,275.0,27,18745.56,2,4,4,10
14608.0,60.0,12,3273.44,3,4,4,11
14609.0,465.0,11,1366.2,1,4,3,8
14610.0,456.0,2,24.35,1,1,1,3
14611.0,0.0,3,599.38,4,2,2,8
14612.0,0.0,1,877.7,4,1,3,8
14613.0,0.0,1,76.32000000000001,4,1,1,6
14614.0,0.0,1,295.13,4,1,1,6
14615.0,426.0,6,934.26,1,3,3,7
14616.0,37.0,5,527.78,3,3,2,8
14617.0,668.0,2,190.47000000000003,1,1,1,3
14618.0,193.0,9,1295.67,2,4,3,9
14619.0,129.0,3,1276.31,2,2,3,7
14620.0,342.0,3,393.28000000000003,2,2,2,6
14621.0,91.0,16,2878.27,3,4,4,11
14622.0,127.0,1,320.58000000000004,2,1,1,4
14623.0,153.0,12,2030.83,2,4,3,9
14624.0,31.0,6,814.07,3,3,2,8
14625.0,158.0,18,4391.53,2,4,4,10
14626.0,94.0,15,5374.77,3,4,4,11
14627.0,343.0,3,406.40000000000003,2,2,2,6
14628.0,37.0,5,1998.0,3,3,3,9
14629.0,213.0,3,939.21,2,2,3,7
14630.0,368.0,1,338.65,1,1,2,4
14631.0,429.0,7,2023.17,1,3,3,7
14632.0,0.0,1,114.56,4,1,1,6
14633.0,0.0,1,344.90000000000003,4,1,2,7
14634.0,585.0,7,1971.82,1,3,3,7
14635.0,367.0,1,215.22,1,1,1,3
14636.0,275.0,2,609.85,2,1,2,5
14637.0,0.0,1,106.67999999999999,4,1,1,6
14638.0,0.0,1,443.6,4,1,2,7
14639.0,33.0,11,4946.81,3,4,4,11
14640.0,31.0,16,3464.03,3,4,4,11
14641.0,0.0,1,110.46,4,1,1,6
14642.0,1.0,1,96.12,3,1,1,5
14643.0,706.0,6,1654.69,1,3,3,7
14644.0,62.0,12,2077.47,3,4,3,10
14645.0,99.0,4,840.24,3,2,2,7
14646.0,3.0,164,523342.07,3,4,4,11
14647.0,613.0,2,519.97,1,1,2,4
14648.0,618.0,19,4458.21,1,4,4,9
14649.0,36.0,11,3754.16,3,4,4,11
14650.0,0.0,1,62.5,4,1,1,6
14651.0,6.0,9,2034.1200000000001,3,4,3,10
14652.0,0.0,1,114.18,4,1,1,6
14653.0,121.0,12,3614.54,2,4,4,10
14654.0,1063.0,1,246.86,1,1,1,3
14655.0,182.0,12,3829.23,2,4,4,10
14656.0,342.0,5,814.65,2,3,2,7
14657.0,156.0,7,1450.92,2,3,3,8
14658.0,243.0,2,247.15,2,1,1,4
14659.0,189.0,12,2456.53,2,4,4,10
14660.0,0.0,2,285.74,4,1,1,6
14661.0,0.0,1,107.95,4,1,1,6
14662.0,30.0,7,1416.33,3,3,3,9
14663.0,580.0,2,490.6,1,1,2,4
14664.0,183.0,2,637.89,2,1,2,5
14665.0,32.0,9,2172.33,3,4,3,10
14666.0,0.0,1,195.25,4,1,1,6
14667.0,69.0,61,21720.59,3,4,4,11
14668.0,0.0,1,111.63,4,1,1,6
14669.0,7.0,7,3243.93,3,3,4,10
14670.0,252.0,3,602.0,2,2,2,6
14671.0,492.0,2,1127.45,1,1,3,5
14672.0,163.0,4,1113.14,2,2,3,7
14673.0,182.0,7,3410.81,2,3,4,9
14674.0,0.0,1,173.66,4,1,1,6
14675.0,0.0,2,1066.9,4,1,3,8
14676.0,39.0,16,8285.49,3,4,4,11
14677.0,0.0,1,184.91,4,1,1,6
14678.0,462.0,2,386.44,1,1,2,4
14679.0,552.0,5,1270.3999999999999,1,3,3,7
14680.0,64.0,87,54801.34,3,4,4,11
14681.0,6.0,6,875.1500000000001,3,3,3,9
14682.0,219.0,6,1514.81,2,3,3,8
14683.0,0.0,1,146.56,4,1,1,6
14684.0,128.0,6,1468.55,2,3,3,8
14685.0,371.0,13,4324.31,1,4,4,9
14686.0,0.0,6,877.88,4,3,3,10
14687.0,553.0,3,1402.06,1,2,3,6
14688.0,1.0,34,7190.08,3,4,4,11
14689.0,0.0,1,112.8,4,1,1,6
14690.0,34.0,5,781.24,3,3,2,8
14691.0,36.0,5,2114.33,3,3,3,9
14692.0,368.0,13,1735.59,1,4,3,8
14693.0,367.0,8,1139.86,1,3,3,7
14694.0,705.0,1,244.31,1,1,1,3
14695.0,491.0,4,1552.57,1,2,3,6
14696.0,3.0,10,2758.67,3,4,4,11
14697.0,220.0,2,188.60999999999999,2,1,1,4
14698.0,121.0,5,1250.76,2,3,3,8
14699.0,97.0,4,702.6,3,2,2,7
14700.0,153.0,5,3116.26,2,3,4,9
14701.0,190.0,18,4498.94,2,4,4,10
14702.0,101.0,32,6695.72,2,4,4,10
14703.0,0.0,1,318.17,4,1,1,6
14704.0,5.0,11,1813.57,3,4,3,10
14705.0,0.0,1,179.0,4,1,1,6
14706.0,0.0,1,390.69,4,1,2,7
14707.0,371.0,2,139.2,1,1,1,3
14708.0,126.0,6,2182.58,2,3,4,9
14709.0,91.0,27,8866.48,3,4,4,11
14710.0,31.0,13,1922.59,3,4,3,10
14711.0,93.0,12,2838.2,3,4,4,11
14712.0,61.0,4,1328.0700000000002,3,2,3,8
14713.0,61.0,25,5372.47,3,4,4,11
14714.0,609.0,7,896.4,1,3,3,7
14715.0,10.0,8,1840.45,3,3,3,9
14716.0,0.0,3,565.45,4,2,2,8
14717.0,912.0,2,72.8,1,1,1,3
14718.0,0.0,1,226.42,4,1,1,6
14719.0,62.0,6,1592.18,3,3,3,9
14720.0,32.0,3,663.81,3,2,2,7
14721.0,0.0,1,115.77,4,1,1,6
14722.0,429.0,3,513.37,1,2,2,5
14723.0,275.0,11,2093.06,2,4,3,9
14724.0,0.0,1,345.25,4,1,2,7
14725.0,426.0,5,1264.84,1,3,3,7
14726.0,0.0,1,124.75,4,1,1,6
14727.0,69.0,4,291.13,3,2,1,6
14728.0,0.0,1,190.58,4,1,1,6
14729.0,698.0,3,907.38,1,2,3,6
14730.0,121.0,8,2005.06,2,3,3,8
14731.0,36.0,3,380.02,3,2,2,7
14732.0,2.0,24,5447.52,3,4,4,11
14733.0,40.0,18,16050.6,3,4,4,11
14734.0,427.0,5,1045.47,1,3,3,7
14735.0,182.0,59,11909.710000000001,2,4,4,10
14736.0,398.0,2,401.08,1,1,2,4
14737.0,182.0,4,3554.17,2,2,4,8
14738.0,6.0,12,1763.64,3,4,3,10
14739.0,152.0,28,12269.57,2,4,4,10
14740.0,339.0,13,4068.86,2,4,4,10
14741.0,667.0,7,1897.59,1,3,3,7
14742.0,0.0,1,579.85,4,1,2,7
14743.0,0.0,1,50.48,4,1,1,6
14744.0,31.0,17,3821.02,3,4,4,11
14745.0,127.0,17,2491.46,2,4,4,10
14746.0,366.0,4,593.5,1,2,2,5
14747.0,190.0,2,294.3,2,1,1,4
14748.0,10.0,16,2672.25,3,4,4,11
14749.0,0.0,1,310.15,4,1,1,6
14750.0,1003.0,1,112.03,1,1,1,3
14751.0,0.0,2,126.45,4,1,1,6
14752.0,0.0,1,389.64,4,1,2,7
14753.0,581.0,2,869.51,1,1,3,5
14754.0,427.0,7,1546.28,1,3,3,7
14755.0,101.0,30,9851.45,2,4,4,10
14756.0,396.0,4,2613.46,1,2,4,7
14757.0,0.0,1,420.5,4,1,2,7
14758.0,487.0,7,2864.97,1,3,4,8
14759.0,213.0,3,1625.97,2,2,3,7
14760.0,0.0,2,53.8,4,1,1,6
14761.0,1.0,3,447.92,3,2,2,7
14762.0,0.0,2,417.57,4,1,2,7
14763.0,881.0,1,-9.95,1,1,1,3
14764.0,0.0,2,250.55,4,1,1,6
14765.0,60.0,3,254.11,3,2,1,6
14766.0,67.0,14,6431.9800000000005,3,4,4,11
14767.0,0.0,1,382.81,4,1,2,7
14768.0,247.0,3,139.5,2,2,1,5
14769.0,152.0,21,15696.67,2,4,4,10
14770.0,522.0,9,3624.89,1,4,4,9
14771.0,1004.0,3,579.92,1,2,2,5
14772.0,0.0,1,139.26,4,1,1,6
14773.0,0.0,2,125.7,4,1,1,6
14774.0,0.0,1,241.45,4,1,1,6
14775.0,1.0,3,1418.46,3,2,3,8
14776.0,219.0,19,3339.02,2,4,4,10
14777.0,213.0,4,239.26,2,2,1,5
14778.0,247.0,2,730.86,2,1,2,5
14779.0,252.0,3,386.15,2,2,2,6
14780.0,0.0,2,447.68,4,1,2,7
14781.0,0.0,1,-530.31,4,1,1,6
14782.0,0.0,1,200.10000000000002,4,1,1,6
14783.0,0.0,2,305.35,4,1,1,6
14784.0,0.0,3,449.93,4,2,2,8
14785.0,0.0,2,77.4,4,1,1,6
14786.0,523.0,1,90.96,1,1,1,3
14787.0,0.0,1,110.65,4,1,1,6
14788.0,302.0,3,1156.32,2,2,3,7
14789.0,30.0,1,197.64,3,1,1,5
14790.0,3.0,10,2526.62,3,4,4,11
14791.0,372.0,1,303.63,1,1,1,3
14792.0,154.0,2,0.0,2,1,1,4
14793.0,213.0,3,611.0500000000001,2,2,2,6
14794.0,91.0,13,1889.15,3,4,3,10
14795.0,0.0,1,131.45000000000002,4,1,1,6
14796.0,34.0,39,10691.12,3,4,4,11
14797.0,0.0,1,300.31,4,1,1,6
14798.0,312.0,9,715.11,2,4,2,8
14799.0,1032.0,2,338.15,1,1,2,4
14800.0,31.0,23,7415.59,3,4,4,11
14801.0,92.0,1,193.14,3,1,1,5
14802.0,580.0,6,-1502.98,1,3,1,5
14803.0,99.0,3,845.55,3,2,3,8
14804.0,333.0,1,353.27,2,1,2,5
14805.0,399.0,7,1104.64,1,3,3,7
14806.0,0.0,2,303.43,4,1,1,6
14807.0,0.0,2,519.29,4,1,2,7
14808.0,65.0,15,2175.37,3,4,3,10
14809.0,0.0,2,686.76,4,1,2,7
14810.0,101.0,13,2537.02,2,4,4,10
14811.0,0.0,1,170.5,4,1,1,6
14812.0,0.0,1,185.8,4,1,1,6
14813.0,494.0,4,1090.87,1,2,3,6
14814.0,524.0,1,160.46,1,1,1,3
14815.0,275.0,2,778.5,2,1,2,5
14816.0,0.0,1,271.85,4,1,1,6
14817.0,161.0,9,3889.21,2,4,4,10
14818.0,520.0,6,1170.41,1,3,3,7
14819.0,184.0,4,470.16,2,2,2,6
14820.0,183.0,9,1274.76,2,4,3,9
14821.0,486.0,7,1286.45,1,3,3,7
14822.0,398.0,1,157.70000000000002,1,1,1,3
14823.0,5.0,3,321.43,3,2,1,6
14824.0,93.0,12,3952.51,3,4,4,11
14825.0,32.0,27,4886.28,3,4,4,11
14826.0,524.0,2,385.2,1,1,2,4
14827.0,374.0,1,0.0,1,1,1,3
14828.0,163.0,14,9803.460000000001,2,4,4,10
14829.0,61.0,9,1639.94,3,4,3,10
14830.0,0.0,1,197.13,4,1,1,6
14831.0,675.0,7,1623.97,1,3,3,7
14832.0,0.0,3,-274.63,4,2,1,7
14833.0,0.0,1,94.8,4,1,1,6
14834.0,1.0,9,2184.21,3,4,4,11
14835.0,705.0,3,293.09999999999997,1,2,1,4
14836.0,30.0,3,102.44999999999999,3,2,1,6
14837.0,32.0,12,3445.82,3,4,4,11
14838.0,366.0,2,773.6700000000001,1,1,2,4
14839.0,462.0,3,915.28,1,2,3,6
14840.0,0.0,3,340.21,4,2,2,8
14841.0,31.0,14,7163.0,3,4,4,11
14842.0,70.0,8,2456.8,3,3,4,10
14843.0,0.0,1,211.79999999999998,4,1,1,6
14844.0,7.0,12,6688.43,3,4,4,11
14845.0,0.0,1,150.0,4,1,1,6
14846.0,366.0,2,406.79999999999995,1,1,2,4
14847.0,609.0,4,1320.6,1,2,3,6
14848.0,0.0,1,310.56,4,1,1,6
14849.0,3.0,50,15542.44,3,4,4,11
14850.0,343.0,9,1575.21,2,4,3,9
14851.0,0.0,3,829.4100000000001,4,2,2,8
14852.0,1.0,21,6123.63,3,4,4,11
14853.0,6.0,7,1351.37,3,3,3,9
14854.0,69.0,14,4302.17,3,4,4,11
14855.0,3.0,7,6520.3,3,3,4,10
14856.0,275.0,3,1311.3799999999999,2,2,3,7
14857.0,31.0,10,3578.931,3,4,4,11
14858.0,0.0,1,180.75,4,1,1,6
14859.0,645.0,6,1703.94,1,3,3,7
14860.0,333.0,2,168.62,2,1,1,4
14861.0,375.0,14,1318.4,1,4,3,8
14862.0,0.0,2,841.1999999999999,4,1,2,7
14863.0,61.0,1,266.76,3,1,1,5
14864.0,851.0,1,-48.75,1,1,1,3
14865.0,302.0,4,129.72,2,2,1,5
14866.0,31.0,20,20657.77,3,4,4,11
14867.0,158.0,19,2901.46,2,4,4,10
14868.0,33.0,13,4170.06,3,4,4,11
14869.0,182.0,9,2776.8,2,4,4,10
14870.0,609.0,9,1794.6000000000001,1,4,3,8
14871.0,182.0,9,1258.97,2,4,3,9
14872.0,615.0,4,802.6800000000001,1,2,2,5
14873.0,0.0,2,854.13,4,1,3,8
14874.0,0.0,1,116.18,4,1,1,6
14875.0,0.0,7,2841.55,4,3,4,11
14876.0,552.0,2,256.7,1,1,1,3
14877.0,526.0,2,437.0,1,1,2,4
14878.0,5.0,28,3812.2200000000003,3,4,4,11
14879.0,0.0,1,185.06,4,1,1,6
14880.0,158.0,3,706.19,2,2,2,6
14881.0,0.0,1,255.4,4,1,1,6
14882.0,183.0,15,3426.55,2,4,4,10
14883.0,6.0,7,756.64,3,3,2,8
14884.0,496.0,1,120.6,1,1,1,3
14885.0,488.0,4,1496.12,1,2,3,6
14886.0,341.0,1,364.8,2,1,2,5
14887.0,0.0,1,1862.0,4,1,3,8
14888.0,0.0,1,369.2,4,1,2,7
14889.0,163.0,1,135.9,2,1,1,4
14890.0,0.0,3,817.25,4,2,2,8
14891.0,219.0,4,1106.73,2,2,3,7
14892.0,0.0,1,202.35000000000002,4,1,1,6
14893.0,706.0,6,1782.26,1,3,3,7
14894.0,1032.0,5,1412.21,1,3,3,7
14895.0,61.0,48,24488.82,3,4,4,11
14896.0,455.0,10,1973.47,1,4,3,8
14897.0,2.0,9,3100.7400000000002,3,4,4,11
14898.0,70.0,18,3356.86,3,4,4,11
14899.0,456.0,1,1384.88,1,1,3,5
14900.0,583.0,1,13.919999999999998,1,1,1,3
14901.0,2.0,13,2277.05,3,4,4,11
14902.0,456.0,5,1000.27,1,3,3,7
14903.0,64.0,10,2744.48,3,4,4,11
14904.0,152.0,4,1640.64,2,2,3,7
14905.0,126.0,10,1939.69,2,4,3,9
14906.0,0.0,3,-66.98,4,2,1,7
14907.0,30.0,23,6094.6900000000005,3,4,4,11
14908.0,670.0,2,381.9,1,1,2,4
14909.0,519.0,5,1380.98,1,3,3,7
14910.0,122.0,7,389.86,2,3,2,7
14911.0,1.0,510,270248.53,3,4,4,11
14912.0,160.0,11,748.5799999999998,2,4,2,8
14913.0,38.0,8,4073.13,3,3,4,10
14914.0,0.0,1,-5.85,4,1,1,6
14915.0,93.0,13,1752.65,3,4,3,10
14916.0,155.0,11,2888.21,2,4,4,10
14917.0,0.0,2,1123.75,4,1,3,8
14918.0,126.0,9,5955.81,2,4,4,10
14919.0,0.0,1,359.35,4,1,2,7
14920.0,36.0,3,1607.17,3,2,3,8
14921.0,91.0,2,1316.07,3,1,3,7
14922.0,395.0,2,843.74,1,1,2,4
14923.0,0.0,1,749.1,4,1,2,7
14924.0,129.0,3,931.01,2,2,3,7
14925.0,851.0,1,-7.95,1,1,1,3
14926.0,0.0,3,337.65,4,2,2,8
14927.0,487.0,1,308.2,1,1,1,3
14928.0,0.0,2,204.46,4,1,1,6
14929.0,152.0,2,836.69,2,1,2,5
14930.0,69.0,9,5136.64,3,4,4,11
14931.0,213.0,6,964.6800000000001,2,3,3,8
14932.0,455.0,2,1029.66,1,1,3,5
14933.0,0.0,5,885.0,4,3,3,10
14934.0,311.0,9,2444.1,2,4,4,10
14935.0,0.0,2,2849.83,4,1,4,9
14936.0,99.0,14,12378.46,3,4,4,11
14937.0,337.0,4,1617.63,2,2,3,7
14938.0,0.0,4,2289.43,4,2,4,10
14939.0,0.0,1,-934.66,4,1,1,6
14940.0,912.0,2,531.49,1,1,2,4
14941.0,432.0,1,182.1,1,1,1,3
14942.0,403.0,5,706.56,1,3,2,6
14943.0,0.0,1,107.62,4,1,1,6
14944.0,61.0,24,9674.92,3,4,4,11
14945.0,0.0,1,179.4,4,1,1,6
14946.0,0.0,1,100.9,4,1,1,6
14947.0,337.0,6,1049.79,2,3,3,8
14948.0,122.0,7,1066.57,2,3,3,8
14949.0,550.0,6,498.55,1,3,2,6
14950.0,333.0,2,361.25,2,1,2,5
14951.0,0.0,1,311.69,4,1,1,6
14952.0,2.0,43,17244.25,3,4,4,11
14953.0,0.0,5,1005.37,4,3,3,10
14954.0,589.0,2,503.44,1,1,2,4
14955.0,882.0,1,163.77,1,1,1,3
14956.0,0.0,1,1325.0,4,1,3,8
14957.0,587.0,2,333.29,1,1,2,4
14958.0,129.0,6,957.9399999999999,2,3,3,8
14959.0,31.0,5,684.97,3,3,2,8
14960.0,333.0,2,221.27,2,1,1,4
14961.0,7.0,28,16328.9,3,4,4,11
14962.0,615.0,4,366.91,1,2,2,5
14963.0,96.0,13,3158.63,3,4,4,11
14964.0,190.0,1,206.21,2,1,1,4
14965.0,246.0,2,599.0,2,1,2,5
14966.0,668.0,6,1115.8400000000001,1,3,3,7
14967.0,1004.0,7,1680.52,1,3,3,7
14968.0,91.0,2,504.99,3,1,2,6
14969.0,589.0,1,906.23,1,1,3,5
14970.0,304.0,16,3593.4,2,4,4,10
14971.0,244.0,3,1116.57,2,2,3,7
14972.0,278.0,2,145.07,2,1,1,4
14973.0,0.0,3,1314.45,4,2,3,9
14974.0,303.0,1,114.39,2,1,1,4
14975.0,0.0,2,472.39,4,1,2,7
14976.0,69.0,8,765.86,3,3,2,8
14977.0,0.0,1,31.929999999999996,4,1,1,6
14978.0,580.0,12,3106.34,1,4,4,9
14979.0,973.0,1,439.46,1,1,2,4
14980.0,1032.0,1,150.68,1,1,1,3
14981.0,160.0,3,313.52,2,2,1,5
14982.0,0.0,1,237.78,4,1,1,6
14983.0,0.0,1,183.20000000000002,4,1,1,6
14984.0,5.0,6,1271.41,3,3,3,9
14985.0,0.0,2,296.75,4,1,1,6
14986.0,0.0,2,566.9,4,1,2,7
14987.0,455.0,9,1632.25,1,4,3,8
14988.0,6.0,7,2066.6,3,3,3,9
14989.0,0.0,1,342.4,4,1,2,7
14990.0,555.0,2,305.42,1,1,1,3
14991.0,580.0,1,314.67,1,1,1,3
14992.0,0.0,1,210.5,4,1,1,6
14993.0,0.0,1,36.13,4,1,1,6
14994.0,365.0,8,886.33,2,3,3,8
14995.0,252.0,2,233.23000000000002,2,1,1,4
14996.0,0.0,2,442.28999999999996,4,1,2,7
14997.0,2.0,5,771.38,3,3,2,8
14998.0,7.0,4,770.73,3,2,2,7
14999.0,0.0,1,129.48000000000002,4,1,1,6
15000.0,0.0,1,490.52,4,1,2,7
15001.0,426.0,2,230.85999999999999,1,1,1,3
15002.0,224.0,9,4817.28,2,4,4,10
15003.0,465.0,7,1055.7,1,3,3,7
15004.0,0.0,1,1246.32,4,1,3,8
15005.0,101.0,76,13763.27,2,4,4,10
15006.0,367.0,2,825.14,1,1,2,4
15007.0,279.0,1,156.91,2,1,1,4
15008.0,373.0,2,360.0,1,1,2,4
15009.0,0.0,3,1261.78,4,2,3,9
15010.0,244.0,1,308.94,2,1,1,4
15011.0,456.0,2,416.6,1,1,2,4
15012.0,371.0,3,860.62,1,2,3,6
15013.0,459.0,10,1641.3,1,4,3,8
15014.0,0.0,2,260.17,4,1,1,6
15015.0,402.0,20,2275.82,1,4,4,9
15016.0,395.0,6,622.3,1,3,2,6
15017.0,183.0,1,125.58,2,1,1,4
15018.0,221.0,4,567.51,2,2,2,6
15019.0,0.0,1,266.0,4,1,1,6
15020.0,0.0,1,203.42,4,1,1,6
15021.0,187.0,17,2689.59,2,4,4,10
15022.0,0.0,5,1186.09,4,3,3,10
15023.0,130.0,23,12092.19,2,4,4,10
15024.0,30.0,16,4075.51,3,4,4,11
15025.0,183.0,2,1013.09,2,1,3,6
15026.0,161.0,5,1061.61,2,3,3,8
15027.0,91.0,13,2974.04,3,4,4,11
15028.0,333.0,6,1157.71,2,3,3,8
15029.0,0.0,2,362.15,4,1,2,7
15030.0,519.0,9,1964.66,1,4,3,8
15031.0,90.0,16,2857.37,3,4,4,11
15032.0,429.0,10,13285.65,1,4,4,9
15033.0,125.0,11,2571.02,2,4,4,10
15034.0,30.0,17,8282.45,3,4,4,11
15035.0,32.0,1,252.73000000000002,3,1,1,5
15036.0,0.0,3,465.55,4,2,2,8
15037.0,0.0,2,402.51,4,1,2,7
15038.0,1.0,10,1269.96,3,4,3,10
15039.0,71.0,107,39742.99,3,4,4,11
15040.0,0.0,1,7.49,4,1,1,6
15041.0,0.0,2,294.02,4,1,1,6
15042.0,0.0,2,315.45,4,1,1,6
15043.0,122.0,6,2873.7999999999997,2,3,4,9
15044.0,7.0,47,15841.53,3,4,4,11
15045.0,34.0,3,633.66,3,2,2,7
15046.0,70.0,28,7583.38,3,4,4,11
15047.0,0.0,1,343.62,4,1,2,7
15048.0,215.0,5,479.27,2,3,2,7
15049.0,38.0,1,121.17000000000002,3,1,1,5
15050.0,0.0,7,4138.87,4,3,4,11
15051.0,4.0,10,3920.16,3,4,4,11
15052.0,0.0,1,215.78,4,1,1,6
15053.0,187.0,3,697.79,2,2,2,6
15054.0,0.0,2,302.1,4,1,1,6
15055.0,0.0,3,560.07,4,2,2,8
15056.0,522.0,1,133.45,1,1,1,3
15057.0,99.0,6,3184.56,3,3,4,10
15058.0,68.0,17,3377.18,3,4,4,11
15059.0,101.0,27,3427.62,2,4,4,10
15060.0,333.0,4,303.09,2,2,1,5
15061.0,6.0,138,136391.48,3,4,4,11
15062.0,189.0,8,2585.62,2,3,4,9
15063.0,67.0,1,370.79999999999995,3,1,2,6
15064.0,612.0,4,1254.41,1,2,3,6
15065.0,303.0,7,3304.71,2,3,4,9
15066.0,122.0,2,760.59,2,1,2,5
15067.0,311.0,6,3865.13,2,3,4,9
15068.0,0.0,4,1176.85,4,2,3,9
15069.0,0.0,1,1109.53,4,1,3,8
15070.0,667.0,3,843.25,1,2,2,5
15071.0,99.0,4,1455.56,3,2,3,8
15072.0,0.0,1,187.51999999999998,4,1,1,6
15073.0,158.0,9,2357.04,2,4,4,10
15074.0,549.0,3,1566.33,1,2,3,6
15075.0,0.0,1,773.03,4,1,2,7
15076.0,369.0,5,1425.84,1,3,3,7
15077.0,457.0,4,2423.88,1,2,4,7
15078.0,94.0,64,17576.52,3,4,4,11
15079.0,36.0,17,3686.75,3,4,4,11
15080.0,488.0,2,546.25,1,1,2,4
15081.0,215.0,13,1948.27,2,4,3,9
15082.0,465.0,1,93.35000000000001,1,1,1,3
15083.0,0.0,1,88.2,4,1,1,6
15084.0,617.0,2,965.2,1,1,3,5
15085.0,790.0,1,347.54,1,1,2,4
15086.0,0.0,2,218.53,4,1,1,6
15087.0,283.0,1,306.94,2,1,1,4
15088.0,276.0,3,1140.27,2,2,3,7
15089.0,185.0,6,2420.84,2,3,4,9
15090.0,253.0,1,381.32,2,1,2,5
15091.0,276.0,6,1023.11,2,3,3,8
15092.0,128.0,4,773.16,2,2,2,6
15093.0,69.0,34,13657.880000000001,3,4,4,11
15094.0,587.0,2,83.0,1,1,1,3
15095.0,188.0,11,3135.74,2,4,4,10
15096.0,0.0,1,219.39000000000001,4,1,1,6
15097.0,213.0,5,587.05,2,3,2,7
15098.0,66.0,5,649.5,3,3,2,8
15099.0,0.0,1,410.48,4,1,2,7
15100.0,71.0,14,2319.5,3,4,4,11
15101.0,192.0,11,1303.49,2,4,3,9
15102.0,400.0,2,554.67,1,1,2,4
15103.0,122.0,2,703.36,2,1,2,5
15104.0,311.0,3,1002.54,2,2,3,7
15105.0,276.0,9,3094.91,2,4,4,10
15106.0,6.0,7,1407.73,3,3,3,9
15107.0,40.0,12,856.26,3,4,3,10
15108.0,66.0,5,1291.75,3,3,3,9
15109.0,129.0,4,961.9,2,2,3,7
15110.0,64.0,9,1480.0,3,4,3,10
15111.0,61.0,5,2730.87,3,3,4,10
15112.0,525.0,1,209.4,1,1,1,3
15113.0,0.0,4,3439.41,4,2,4,10
15114.0,39.0,12,3400.12,3,4,4,11
15115.0,882.0,3,528.1,1,2,2,5
15116.0,0.0,4,1352.75,4,2,3,9
15117.0,33.0,9,2484.32,3,4,4,11
15118.0,0.0,1,244.8,4,1,1,6
15119.0,129.0,1,266.4,2,1,1,4
15120.0,306.0,2,343.82,2,1,2,5
15121.0,0.0,2,457.72,4,1,2,7
15122.0,372.0,16,4461.42,1,4,4,9
15123.0,302.0,5,4656.17,2,3,4,9
15124.0,339.0,4,450.82,2,2,2,6
15125.0,31.0,36,16124.33,3,4,4,11
15126.0,0.0,2,449.49,4,1,2,7
15127.0,215.0,2,711.5,2,1,2,5
15128.0,62.0,9,1732.22,3,4,3,10
15129.0,217.0,23,6860.18,2,4,4,10
15130.0,0.0,1,330.11,4,1,2,7
15131.0,426.0,1,80.28,1,1,1,3
15132.0,0.0,5,977.9300000000001,4,3,3,10
15133.0,39.0,5,1806.9,3,3,3,9
15134.0,67.0,10,1596.29,3,4,3,10
15135.0,704.0,3,293.78,1,2,1,4
15136.0,1.0,5,1282.45,3,3,3,9
15137.0,522.0,5,747.55,1,3,2,6
15138.0,395.0,2,486.59000000000003,1,1,2,4
15139.0,163.0,2,178.96,2,1,1,4
15140.0,339.0,9,3239.44,2,4,4,10
15141.0,368.0,9,1378.31,1,4,3,8
15142.0,368.0,7,2608.97,1,3,4,8
15143.0,641.0,2,563.63,1,1,2,4
15144.0,1.0,33,12006.51,3,4,4,11
15145.0,212.0,4,1194.73,2,2,3,7
15146.0,0.0,3,1313.66,4,2,3,9
15147.0,220.0,2,608.65,2,1,2,5
15148.0,0.0,1,301.29,4,1,1,6
15149.0,371.0,5,1554.6100000000001,1,3,3,7
15150.0,153.0,14,8990.58,2,4,4,10
15151.0,366.0,2,2085.61,1,1,3,5
15152.0,62.0,18,5197.97,3,4,4,11
15153.0,122.0,1,329.25,2,1,2,5
15154.0,0.0,4,1332.26,4,2,3,9
15155.0,0.0,1,383.96999999999997,4,1,2,7
15156.0,120.0,3,961.49,2,2,3,7
15157.0,125.0,7,2587.54,2,3,4,9
15158.0,609.0,3,437.66,1,2,2,5
15159.0,32.0,38,22049.4,3,4,4,11
15160.0,609.0,4,589.27,1,2,2,5
15161.0,0.0,1,119.92,4,1,1,6
15162.0,759.0,2,241.5,1,1,1,3
15163.0,0.0,2,304.47,4,1,1,6
15164.0,254.0,10,2052.02,2,4,3,9
15165.0,698.0,1,975.5,1,1,3,5
15166.0,0.0,1,167.16,4,1,1,6
15167.0,618.0,5,1659.67,1,3,3,7
15168.0,0.0,1,106.56,4,1,1,6
15169.0,0.0,2,569.22,4,1,2,7
15170.0,0.0,1,81.15,4,1,1,6
15171.0,10.0,2,1034.5,3,1,3,7
15172.0,333.0,5,1624.05,2,3,3,8
15173.0,461.0,8,1399.26,1,3,3,7
15174.0,0.0,2,481.46,4,1,2,7
15175.0,0.0,1,224.14,4,1,1,6
15176.0,435.0,2,985.09,1,1,3,5
15177.0,427.0,1,948.93,1,1,3,5
15178.0,0.0,1,40.5,4,1,1,6
15179.0,341.0,17,7426.82,2,4,4,10
15180.0,517.0,3,904.4300000000001,1,2,3,6
15181.0,245.0,8,948.4499999999999,2,3,3,8
15182.0,126.0,14,2942.752,2,4,4,10
15183.0,431.0,4,637.03,1,2,2,5
15184.0,61.0,4,689.95,3,2,2,7
15185.0,0.0,1,310.62,4,1,1,6
15186.0,371.0,5,1403.2,1,3,3,7
15187.0,36.0,18,4670.08,3,4,4,11
15188.0,0.0,1,310.43,4,1,1,6
15189.0,7.0,58,17101.13,3,4,4,11
15190.0,700.0,1,834.4399999999999,1,1,2,4
15191.0,670.0,3,588.05,1,2,2,5
15192.0,3.0,5,1981.39,3,3,3,9
15193.0,62.0,1,499.32,3,1,2,6
15194.0,5.0,39,12187.68,3,4,4,11
15195.0,152.0,1,3861.0,2,1,4,7
15196.0,641.0,2,316.25,1,1,1,3
15197.0,10.0,10,1427.84,3,4,3,10
15198.0,124.0,6,559.45,2,3,2,7
15199.0,31.0,10,3122.4,3,4,4,11
15200.0,671.0,1,549.05,1,1,2,4
15201.0,64.0,14,1525.9,3,4,3,10
15202.0,0.0,8,-2570.1800000000003,4,3,1,8
15203.0,343.0,15,4400.18,2,4,4,10
15204.0,0.0,1,316.58,4,1,1,6
15205.0,247.0,3,648.8299999999999,2,2,2,6
15206.0,99.0,4,420.29999999999995,3,2,2,7
15207.0,430.0,5,653.77,1,3,2,6
15208.0,31.0,7,968.02,3,3,3,9
15209.0,819.0,1,178.98000000000002,1,1,1,3
15210.0,0.0,3,1176.19,4,2,3,9
15211.0,62.0,2,1277.48,3,1,3,7
15212.0,7.0,3,195.42999999999998,3,2,1,6
15213.0,0.0,3,325.05,4,2,1,7
15214.0,37.0,8,1661.44,3,3,3,9
15215.0,246.0,11,1496.46,2,4,3,9
15216.0,0.0,2,486.09,4,1,2,7
15217.0,0.0,1,426.24,4,1,2,7
15218.0,189.0,25,11456.0,2,4,4,10
15219.0,707.0,2,685.45,1,1,2,4
15220.0,252.0,7,1758.92,2,3,3,8
15221.0,373.0,7,1816.1000000000001,1,3,3,7
15222.0,528.0,17,3415.66,1,4,4,9
15223.0,251.0,6,1117.1,2,3,3,8
15224.0,364.0,8,837.26,2,3,2,7
15225.0,0.0,1,409.40000000000003,4,1,2,7
15226.0,312.0,1,154.41,2,1,1,4
15227.0,128.0,9,2488.4900000000002,2,4,4,10
15228.0,125.0,7,5570.5199999999995,2,3,4,9
15229.0,674.0,1,160.5,1,1,1,3
15230.0,0.0,2,429.6,4,1,2,7
15231.0,0.0,2,228.35999999999999,4,1,1,6
15232.0,0.0,2,612.06,4,1,2,7
15233.0,640.0,1,59.400000000000006,1,1,1,3
15234.0,130.0,1,197.0,2,1,1,4
15235.0,160.0,16,2937.81,2,4,4,10
15236.0,0.0,1,321.05,4,1,1,6
15237.0,121.0,4,1412.32,2,2,3,7
15238.0,61.0,5,1056.54,3,3,3,9
15239.0,0.0,3,764.34,4,2,2,8
15240.0,7.0,20,4315.0,3,4,4,11
15241.0,96.0,12,3032.31,3,4,4,11
15242.0,0.0,1,302.04,4,1,1,6
15243.0,0.0,2,927.2800000000001,4,1,3,8
15244.0,215.0,4,850.1800000000001,2,2,3,7
15245.0,219.0,8,4610.84,2,3,4,9
15246.0,673.0,3,780.4,1,2,2,5
15247.0,94.0,4,967.11,3,2,3,8
15248.0,0.0,4,1865.03,4,2,3,9
15249.0,3.0,21,9147.15,3,4,4,11
15250.0,464.0,1,60.0,1,1,1,3
15251.0,4.0,31,20095.6,3,4,4,11
15252.0,96.0,7,2053.06,3,3,3,9
15253.0,2.0,12,2033.29,3,4,3,10
15254.0,247.0,4,1073.4,2,2,3,7
15255.0,245.0,11,3670.77,2,4,4,10
15256.0,0.0,2,170.4,4,1,1,6
15257.0,283.0,3,600.9,2,2,2,6
15258.0,189.0,2,623.16,2,1,2,5
15259.0,0.0,4,1182.3799999999999,4,2,3,9
15260.0,188.0,30,9098.38,2,4,4,10
15261.0,700.0,4,1508.0,1,2,3,6
15262.0,490.0,3,418.82,1,2,2,5
15263.0,0.0,1,156.51,4,1,1,6
15264.0,184.0,3,844.2,2,2,3,7
15265.0,34.0,4,3345.64,3,2,4,9
15266.0,224.0,6,841.7,2,3,2,7
15267.0,1.0,5,1717.36,3,3,3,9
15268.0,0.0,4,941.2500000000001,4,2,3,9
15269.0,0.0,3,1225.3600000000001,4,2,3,9
15270.0,39.0,31,7193.99,3,4,4,11
15271.0,5.0,26,4639.29,3,4,4,11
15272.0,0.0,6,2085.48,4,3,3,10
15273.0,0.0,1,228.96,4,1,1,6
15274.0,213.0,2,716.57,2,1,2,5
15275.0,121.0,2,609.19,2,1,2,5
15276.0,245.0,5,631.03,2,3,2,7
15277.0,427.0,2,476.34,1,1,2,4
15278.0,374.0,4,496.15999999999997,1,2,2,5
15279.0,455.0,7,1541.74,1,3,3,7
15280.0,490.0,3,406.21999999999997,1,2,2,5
15281.0,1.0,22,8317.62,3,4,4,11
15282.0,0.0,1,348.59,4,1,2,7
15283.0,459.0,4,135.43,1,2,1,4
15284.0,0.0,1,24.75,4,1,1,6
15285.0,0.0,1,94.92,4,1,1,6
15286.0,0.0,1,240.55,4,1,1,6
15287.0,1032.0,6,854.58,1,3,3,7
15288.0,157.0,10,3883.13,2,4,4,10
15289.0,61.0,7,1570.71,3,3,3,9
15290.0,122.0,30,10355.58,2,4,4,10
15291.0,5.0,53,13451.24,3,4,4,11
15292.0,0.0,1,180.94,4,1,1,6
15293.0,374.0,1,247.5,1,1,1,3
15294.0,608.0,2,222.3,1,1,1,3
15295.0,0.0,1,217.23999999999998,4,1,1,6
15296.0,36.0,20,10223.93,3,4,4,11
15297.0,61.0,4,635.04,3,2,2,7
15298.0,124.0,29,8356.03,2,4,4,10
15299.0,39.0,15,7243.62,3,4,4,11
15300.0,184.0,1,496.44,2,1,2,5
15301.0,219.0,19,7561.21,2,4,4,10
15302.0,820.0,2,291.05,1,1,1,3
15303.0,0.0,4,1178.78,4,2,3,9
15304.0,62.0,11,905.45,3,4,3,10
15305.0,673.0,1,93.6,1,1,1,3
15306.0,124.0,10,3480.98,2,4,4,10
15307.0,216.0,1,205.3,2,1,1,4
15308.0,69.0,2,302.27,3,1,1,5
15309.0,434.0,10,715.53,1,4,2,7
15310.0,0.0,1,1634.64,4,1,3,8
15311.0,1.0,270,113513.07,3,4,4,11
15312.0,128.0,14,2916.4900000000002,2,4,4,10
15313.0,0.0,1,52.0,4,1,1,6
15314.0,487.0,4,800.65,1,2,2,5
15315.0,184.0,3,551.54,2,2,2,6
15316.0,0.0,1,165.0,4,1,1,6
15317.0,851.0,2,112.05000000000001,1,1,1,3
15318.0,182.0,1,312.62,2,1,1,4
15319.0,342.0,1,204.5,2,1,1,4
15320.0,0.0,1,267.13,4,1,1,6
15321.0,648.0,18,6560.650000000001,1,4,4,9
15322.0,183.0,3,1314.15,2,2,3,7
15323.0,525.0,4,320.9,1,2,1,4
15324.0,528.0,1,140.22000000000003,1,1,1,3
15325.0,456.0,9,1596.81,1,4,3,8
15326.0,71.0,10,1529.82,3,4,3,10
15327.0,0.0,1,208.75,4,1,1,6
15328.0,0.0,1,107.24,4,1,1,6
15329.0,244.0,20,2742.98,2,4,4,10
15330.0,62.0,2,714.96,3,1,2,6
15331.0,463.0,4,755.41,1,2,2,5
15332.0,486.0,6,6553.74,1,3,4,8
15333.0,0.0,1,1028.56,4,1,3,8
15334.0,187.0,3,351.67,2,2,2,6
15335.0,0.0,1,173.97,4,1,1,6
15336.0,640.0,1,240.5,1,1,1,3
15337.0,668.0,2,344.72,1,1,2,4
15338.0,0.0,1,283.43,4,1,1,6
15339.0,245.0,11,1634.09,2,4,3,9
15340.0,0.0,1,105.5,4,1,1,6
15341.0,0.0,3,2401.02,4,2,4,10
15342.0,306.0,2,391.76,2,1,2,5
15343.0,0.0,1,364.5,4,1,2,7
15344.0,90.0,5,476.58,3,3,2,8
15345.0,244.0,2,367.69,2,1,2,5
15346.0,40.0,4,591.65,3,2,2,7
15347.0,486.0,6,1333.9,1,3,3,7
15348.0,0.0,1,158.04,4,1,1,6
15349.0,219.0,2,473.81,2,1,2,5
15350.0,698.0,2,663.25,1,1,2,4
15351.0,31.0,15,3615.18,3,4,4,11
15352.0,461.0,1,114.95,1,1,1,3
15353.0,492.0,8,3154.05,1,3,4,8
15354.0,0.0,7,-94.8,4,3,1,8
15355.0,61.0,2,277.05,3,1,1,5
15356.0,122.0,13,3464.95,2,4,4,10
15357.0,0.0,1,-36.75,4,1,1,6
15358.0,2.0,55,16837.35,3,4,4,11
15359.0,465.0,9,162.6,1,4,1,6
15360.0,0.0,1,427.93,4,1,2,7
15361.0,703.0,4,689.07,1,2,2,5
15362.0,1063.0,2,613.08,1,1,2,4
15363.0,7.0,3,996.16,3,2,3,8
15364.0,216.0,2,913.19,2,1,3,6
15365.0,183.0,15,3573.26,2,4,4,10
15366.0,523.0,7,2389.08,1,3,4,8
15367.0,99.0,13,5005.7300000000005,3,4,4,11
15368.0,426.0,2,722.74,1,1,2,4
15369.0,369.0,13,1713.39,1,4,3,8
15370.0,31.0,9,3713.51,3,4,4,11
15371.0,0.0,1,59.400000000000006,4,1,1,6
15372.0,428.0,10,5954.42,1,4,4,9
15373.0,254.0,18,3218.59,2,4,4,10
15374.0,278.0,2,307.32,2,1,1,4
15375.0,0.0,1,60.959999999999994,4,1,1,6
15376.0,340.0,3,1233.3600000000001,2,2,3,7
15377.0,667.0,5,1179.95,1,3,3,7
15378.0,642.0,2,246.5,1,1,1,3
15379.0,99.0,9,4806.4400000000005,3,4,4,11
15380.0,333.0,13,3422.2000000000003,2,4,4,10
15381.0,67.0,6,1887.62,3,3,3,9
15382.0,127.0,20,13646.5,2,4,4,10
15383.0,0.0,1,-10.5,4,1,1,6
15384.0,666.0,5,2014.49,1,3,3,7
15385.0,365.0,3,942.08,2,2,3,7
15386.0,188.0,1,394.14,2,1,2,5
15387.0,612.0,1,468.65,1,1,2,4
15388.0,0.0,1,140.54,4,1,1,6
15389.0,608.0,5,2733.8,1,3,4,8
15390.0,487.0,2,1216.66,1,1,3,5
15391.0,615.0,2,282.92,1,1,1,3
15392.0,2.0,8,2891.82,3,3,4,10
15393.0,283.0,5,891.34,2,3,3,8
15394.0,456.0,13,5251.4,1,4,4,9
15395.0,0.0,1,107.45,4,1,1,6
15396.0,585.0,2,796.38,1,1,2,4
15397.0,0.0,1,94.0,4,1,1,6
15398.0,0.0,3,1339.63,4,2,3,9
15399.0,121.0,3,815.77,2,2,2,6
15400.0,124.0,9,1252.8,2,4,3,9
15401.0,0.0,2,216.95000000000002,4,1,1,6
15402.0,0.0,7,1816.64,4,3,3,10
15403.0,582.0,2,170.88,1,1,1,3
15404.0,0.0,1,257.06,4,1,1,6
15405.0,280.0,2,659.84,2,1,2,5
15406.0,39.0,6,891.77,3,3,3,9
15407.0,96.0,4,1056.44,3,2,3,8
15408.0,0.0,1,267.18,4,1,1,6
15409.0,528.0,2,117.2,1,1,1,3
15410.0,306.0,10,4685.72,2,4,4,10
15411.0,66.0,5,1346.38,3,3,3,9
15412.0,0.0,1,190.53,4,1,1,6
15413.0,436.0,7,-2531.3799999999997,1,3,1,5
15414.0,37.0,3,774.9000000000001,3,2,2,7
15415.0,0.0,1,572.8100000000001,4,1,2,7
15416.0,4.0,9,4554.65,3,4,4,11
15417.0,0.0,1,508.8,4,1,2,7
15418.0,427.0,2,452.32,1,1,2,4
15419.0,0.0,1,135.86,4,1,1,6
15420.0,700.0,6,743.0,1,3,2,6
15421.0,1.0,10,3805.34,3,4,4,11
15422.0,367.0,8,1615.02,1,3,3,7
15423.0,334.0,4,219.14,2,2,1,5
15424.0,670.0,3,597.78,1,2,2,5
15425.0,608.0,4,1944.57,1,2,3,6
15426.0,183.0,11,2592.95,2,4,4,10
15427.0,183.0,3,1483.14,2,2,3,7
15428.0,373.0,4,762.75,1,2,2,5
15429.0,0.0,3,364.90000000000003,4,2,2,8
15430.0,583.0,3,903.75,1,2,3,6
15431.0,0.0,1,153.24,4,1,1,6
15432.0,0.0,4,301.26,4,2,1,7
15433.0,67.0,3,417.87,3,2,2,7
15434.0,122.0,13,2517.11,2,4,4,10
15435.0,0.0,1,149.29,4,1,1,6
15436.0,0.0,3,1122.53,4,2,3,9
15437.0,464.0,2,393.45,1,1,2,4
15438.0,0.0,1,156.57999999999998,4,1,1,6
15439.0,396.0,4,1269.05,1,2,3,6
15440.0,0.0,3,383.68,4,2,2,8
15441.0,396.0,3,1254.21,1,2,3,6
15442.0,221.0,1,594.0,2,1,2,5
15443.0,121.0,16,5116.14,2,4,4,10
15444.0,0.0,2,1418.26,4,1,3,8
15445.0,0.0,2,284.5,4,1,1,6
15446.0,615.0,5,398.85,1,3,2,6
15447.0,0.0,6,484.93,4,3,2,9
15448.0,649.0,2,788.81,1,1,2,4
15449.0,37.0,5,971.22,3,3,3,9
15450.0,91.0,1,429.84,3,1,2,6
15451.0,700.0,2,233.21,1,1,1,3
15452.0,61.0,6,1799.1100000000001,3,3,3,9
15453.0,121.0,7,1388.37,2,3,3,8
15454.0,364.0,2,307.69,2,1,1,4
15455.0,0.0,1,38.25,4,1,1,6
15456.0,342.0,10,2119.27,2,4,3,9
15457.0,0.0,1,237.07,4,1,1,6
15458.0,667.0,2,370.43999999999994,1,1,2,4
15459.0,0.0,2,202.82999999999998,4,1,1,6
15460.0,0.0,1,216.76,4,1,1,6
15461.0,581.0,3,391.29999999999995,1,2,2,5
15462.0,185.0,4,737.05,2,2,2,6
15463.0,61.0,1,126.14,3,1,1,5
15464.0,224.0,1,1048.85,2,1,3,6
15465.0,5.0,39,12226.15,3,4,4,11
15466.0,372.0,4,1571.01,1,2,3,6
15467.0,65.0,4,511.88,3,2,2,7
15468.0,244.0,7,1387.48,2,3,3,8
15469.0,33.0,6,834.4,3,3,2,8
15470.0,0.0,1,63.419999999999995,4,1,1,6
15471.0,152.0,3,1316.56,2,2,3,7
15472.0,0.0,1,371.56,4,1,2,7
15473.0,1.0,11,1740.0,3,4,3,10
15474.0,0.0,1,163.1,4,1,1,6
15475.0,0.0,1,454.10999999999996,4,1,2,7
15476.0,365.0,5,2180.28,2,3,3,8
15477.0,0.0,1,368.4,4,1,2,7
15478.0,0.0,3,2024.98,4,2,3,9
15479.0,912.0,1,147.4,1,1,1,3
15480.0,708.0,7,3592.25,1,3,4,8
15481.0,640.0,1,1993.34,1,1,3,5
15482.0,243.0,24,8107.83,2,4,4,10
15483.0,338.0,10,862.2,2,4,3,9
15484.0,121.0,7,4624.8,2,3,4,9
15485.0,91.0,8,5624.51,3,3,4,10
15486.0,0.0,1,102.0,4,1,1,6
15487.0,0.0,1,231.32,4,1,1,6
15488.0,124.0,5,431.92,2,3,2,7
15489.0,6.0,12,2327.36,3,4,4,11
15490.0,580.0,2,188.1,1,1,1,3
15491.0,65.0,7,3090.85,3,3,4,10
15492.0,30.0,2,659.4599999999999,3,1,2,6
15493.0,153.0,11,4280.43,2,4,4,10
15494.0,64.0,6,3770.95,3,3,4,10
15495.0,0.0,1,246.5,4,1,1,6
15496.0,0.0,1,146.14000000000001,4,1,1,6
15497.0,401.0,11,8643.46,1,4,4,9
15498.0,6.0,55,23860.81,3,4,4,11
15499.0,0.0,1,161.6,4,1,1,6
15500.0,333.0,4,1131.56,2,2,3,7
15501.0,0.0,2,402.5,4,1,2,7
15502.0,32.0,27,8673.53,3,4,4,11
15503.0,364.0,2,267.15,2,1,1,4
15504.0,372.0,5,413.9,1,3,2,6
15505.0,157.0,7,3497.14,2,3,4,9
15506.0,0.0,6,2040.03,4,3,3,10
15507.0,0.0,1,492.36,4,1,2,7
15508.0,250.0,6,1000.27,2,3,3,8
15509.0,0.0,1,166.51,4,1,1,6
15510.0,0.0,1,250.0,4,1,1,6
15511.0,334.0,5,909.23,2,3,3,8
15512.0,157.0,4,331.58,2,2,2,6
15513.0,6.0,41,27264.45,3,4,4,11
15514.0,183.0,20,5422.28,2,4,4,10
15515.0,0.0,1,171.81,4,1,1,6
15516.0,0.0,3,62.43,4,2,1,7
15517.0,0.0,1,267.03,4,1,1,6
15518.0,40.0,23,4103.78,3,4,4,11
15519.0,0.0,2,344.61,4,1,2,7
15520.0,121.0,1,343.5,2,1,2,5
15521.0,36.0,24,6674.44,3,4,4,11
15522.0,153.0,2,398.84,2,1,2,5
15523.0,372.0,18,17220.04,1,4,4,9
15524.0,372.0,2,591.4,1,1,2,4
15525.0,152.0,5,1280.8,2,3,3,8
15526.0,183.0,2,148.44,2,1,1,4
15527.0,32.0,31,5041.78,3,4,4,11
15528.0,0.0,1,229.33,4,1,1,6
15529.0,99.0,13,5084.5,3,4,4,11
15530.0,160.0,5,1813.72,2,3,3,8
15531.0,90.0,2,2007.44,3,1,3,7
15532.0,492.0,12,3708.05,1,4,4,9
15533.0,32.0,5,746.92,3,3,2,8
15534.0,0.0,1,162.25,4,1,1,6
15535.0,455.0,10,985.82,1,4,3,8
15536.0,0.0,1,259.09,4,1,1,6
15537.0,0.0,1,110.92,4,1,1,6
15538.0,464.0,11,3027.15,1,4,4,9
15539.0,302.0,1,538.46,2,1,2,5
15540.0,0.0,2,460.68,4,1,2,7
15541.0,0.0,1,85.13000000000001,4,1,1,6
15542.0,1032.0,4,895.9,1,2,3,6
15543.0,550.0,2,242.84,1,1,1,3
15544.0,3.0,26,8134.12,3,4,4,11
15545.0,638.0,2,428.05,1,1,2,4
15546.0,372.0,3,539.5500000000001,1,2,2,5
15547.0,32.0,28,10140.89,3,4,4,11
15548.0,0.0,1,158.09,4,1,1,6
15549.0,218.0,9,2308.46,2,4,4,10
15550.0,39.0,14,1995.6,3,4,3,10
15551.0,275.0,9,1659.28,2,4,3,9
15552.0,189.0,2,252.52,2,1,1,4
15553.0,62.0,1,437.23,3,1,2,6
15554.0,161.0,1,217.2,2,1,1,4
15555.0,1.0,46,11744.08,3,4,4,11
15556.0,0.0,1,279.77,4,1,1,6
15557.0,30.0,1,473.65000000000003,3,1,2,6
15558.0,434.0,2,143.32999999999998,1,1,1,3
15559.0,0.0,1,1109.4,4,1,3,8
15560.0,518.0,2,153.52,1,1,1,3
15561.0,128.0,9,1856.54,2,4,3,9
15562.0,396.0,3,673.3800000000001,1,2,2,5
15563.0,333.0,11,2781.21,2,4,4,10
15564.0,670.0,2,70.74000000000001,1,1,1,3
15565.0,0.0,2,173.16,4,1,1,6
15566.0,365.0,2,227.87,2,1,1,4
15567.0,0.0,1,186.01,4,1,1,6
15568.0,152.0,3,758.29,2,2,2,6
15569.0,40.0,10,3586.35,3,4,4,11
15570.0,70.0,27,9246.99,3,4,4,11
15571.0,183.0,14,4051.63,2,4,4,10
15572.0,191.0,10,4068.67,2,4,4,10
15573.0,122.0,5,1207.18,2,3,3,8
15574.0,667.0,7,1476.7,1,3,3,7
15575.0,0.0,1,30.1,4,1,1,6
15576.0,303.0,1,940.6700000000001,2,1,3,6
15577.0,34.0,5,397.98,3,3,2,8
15578.0,0.0,1,127.1,4,1,1,6
15579.0,304.0,7,1267.25,2,3,3,8
15580.0,428.0,14,1221.95,1,4,3,8
15581.0,33.0,43,5797.780000000001,3,4,4,11
15582.0,281.0,3,682.9100000000001,2,2,2,6
15583.0,0.0,1,107.86,4,1,1,6
15584.0,527.0,7,1275.0,1,3,3,7
15585.0,0.0,1,455.3,4,1,2,7
15586.0,497.0,4,1128.66,1,2,3,6
15587.0,32.0,7,1522.0800000000002,3,3,3,9
15588.0,0.0,1,579.6,4,1,2,7
15589.0,312.0,4,456.58,2,2,2,6
15590.0,372.0,6,1466.41,1,3,3,7
15591.0,464.0,3,217.9,1,2,1,4
15592.0,0.0,1,388.58,4,1,2,7
15593.0,0.0,1,199.8,4,1,1,6
15594.0,91.0,6,1767.53,3,3,3,9
15595.0,459.0,1,357.6,1,1,2,4
15596.0,69.0,16,3023.59,3,4,4,11
15597.0,61.0,3,554.52,3,2,2,7
15598.0,244.0,4,543.02,2,2,2,6
15599.0,0.0,3,1250.06,4,2,3,9
15600.0,519.0,5,1178.71,1,3,3,7
15601.0,32.0,35,14919.220000000001,3,4,4,11
15602.0,30.0,25,2975.9700000000003,3,4,4,11
15603.0,707.0,3,74.73,1,2,1,4
15604.0,0.0,1,216.39,4,1,1,6
15605.0,32.0,10,1933.4,3,4,3,10
15606.0,3.0,19,4733.47,3,4,4,11
15607.0,163.0,13,1578.57,2,4,3,9
15608.0,30.0,5,1785.98,3,3,3,9
15609.0,66.0,2,270.03000000000003,3,1,1,5
15610.0,0.0,1,112.46000000000001,4,1,1,6
15611.0,69.0,32,2858.37,3,4,4,11
15612.0,92.0,2,195.15,3,1,1,5
15613.0,494.0,1,433.71999999999997,1,1,2,4
15614.0,518.0,7,3008.86,1,3,4,8
15615.0,36.0,54,21282.07,3,4,4,11
15616.0,0.0,1,317.11,4,1,1,6
15617.0,487.0,3,828.5500000000001,1,2,2,5
15618.0,124.0,5,747.031,2,3,2,7
15619.0,0.0,1,336.40000000000003,4,1,2,7
15620.0,67.0,8,1909.93,3,3,3,9
15621.0,213.0,6,1158.77,2,3,3,8
15622.0,99.0,30,7318.08,3,4,4,11
15623.0,395.0,8,2437.05,1,3,4,8
15624.0,0.0,4,588.13,4,2,2,8
15625.0,278.0,14,3203.25,2,4,4,10
15626.0,0.0,4,1049.37,4,2,3,9
15627.0,489.0,2,566.9,1,1,2,4
15628.0,66.0,21,5603.360000000001,3,4,4,11
15629.0,0.0,4,2240.9,4,2,4,10
15630.0,587.0,4,1475.45,1,2,3,6
15631.0,526.0,1,596.67,1,1,2,4
15632.0,64.0,10,3147.31,3,4,4,11
15633.0,374.0,18,4173.41,1,4,4,9
15634.0,0.0,2,554.65,4,1,2,7
15635.0,456.0,1,100.35,1,1,1,3
15636.0,32.0,4,1444.58,3,2,3,8
15637.0,464.0,5,797.59,1,3,2,6
15638.0,39.0,9,2137.2,3,4,3,10
15639.0,0.0,5,1028.33,4,3,3,10
15640.0,40.0,34,23835.41,3,4,4,11
15641.0,311.0,12,5345.55,2,4,4,10
15642.0,790.0,1,105.78000000000002,1,1,1,3
15643.0,127.0,6,647.4,2,3,2,7
15644.0,0.0,4,813.0,4,2,2,8
15645.0,427.0,4,1042.57,1,2,3,6
15646.0,37.0,6,952.11,3,3,3,9
15647.0,0.0,1,169.0,4,1,1,6
15648.0,221.0,4,599.9,2,2,2,6
15649.0,163.0,4,2170.35,2,2,3,7
15650.0,369.0,3,539.03,1,2,2,5
15651.0,275.0,5,1259.06,2,3,3,8
15652.0,93.0,6,1411.84,3,3,3,9
15653.0,124.0,2,877.4399999999999,2,1,3,6
15654.0,0.0,2,922.53,4,1,3,8
15655.0,68.0,2,511.32,3,1,2,6
15656.0,281.0,4,748.5,2,2,2,6
15657.0,0.0,1,30.0,4,1,1,6
15658.0,39.0,13,2270.34,3,4,4,11
15659.0,0.0,3,532.49,4,2,2,8
15660.0,342.0,18,2764.14,2,4,4,10
15661.0,224.0,8,1215.95,2,3,3,8
15662.0,1063.0,2,283.73,1,1,1,3
15663.0,0.0,1,138.14,4,1,1,6
15664.0,519.0,7,1212.35,1,3,3,7
15665.0,68.0,5,4015.12,3,3,4,10
15666.0,702.0,2,632.9399999999999,1,1,2,4
15667.0,0.0,1,301.32,4,1,1,6
15668.0,189.0,1,76.32000000000001,2,1,1,4
15669.0,0.0,5,677.69,4,3,2,9
15670.0,431.0,3,315.2,1,2,1,4
15671.0,37.0,10,2635.4900000000002,3,4,4,11
15672.0,0.0,1,45.300000000000004,4,1,1,6
15673.0,2.0,10,6409.84,3,4,4,11
15674.0,67.0,18,6217.85,3,4,4,11
15675.0,156.0,4,542.04,2,2,2,6
15676.0,67.0,5,3324.09,3,3,4,10
15677.0,670.0,3,1305.63,1,2,3,6
15678.0,456.0,3,1893.89,1,2,3,6
15679.0,66.0,4,781.28,3,2,2,7
15680.0,486.0,12,4464.4800000000005,1,4,4,9
15681.0,30.0,16,2480.2,3,4,4,11
15682.0,0.0,3,316.99,4,2,1,7
15683.0,0.0,2,524.54,4,1,2,7
15684.0,430.0,6,147.8,1,3,1,5
15685.0,0.0,1,55.980000000000004,4,1,1,6
15686.0,0.0,1,90.0,4,1,1,6
15687.0,158.0,11,2981.5,2,4,4,10
15688.0,0.0,1,190.57,4,1,1,6
15689.0,3.0,3,521.03,3,2,2,7
15690.0,213.0,2,239.76,2,1,1,4
15691.0,341.0,5,511.8,2,3,2,7
15692.0,30.0,1,191.04,3,1,1,5
15693.0,0.0,1,37.5,4,1,1,6
15694.0,61.0,29,10566.46,3,4,4,11
15695.0,0.0,4,1131.04,4,2,3,9
15696.0,67.0,21,3757.4700000000003,3,4,4,11
15697.0,0.0,1,246.75,4,1,1,6
15698.0,0.0,1,46.2,4,1,1,6
15699.0,0.0,1,309.65,4,1,1,6
15700.0,0.0,3,664.03,4,2,2,8
15701.0,152.0,4,1542.14,2,2,3,7
15702.0,0.0,2,140.39000000000001,4,1,1,6
15703.0,0.0,1,211.5,4,1,1,6
15704.0,128.0,8,3744.1800000000003,2,3,4,9
15705.0,0.0,1,143.1,4,1,1,6
15706.0,31.0,7,1001.8100000000001,3,3,3,9
15707.0,184.0,4,945.58,2,2,3,7
15708.0,101.0,14,4323.9800000000005,2,4,4,10
15709.0,342.0,2,327.85,2,1,2,5
15710.0,0.0,1,898.87,4,1,3,8
15711.0,704.0,2,420.25,1,1,2,4
15712.0,96.0,13,3467.46,3,4,4,11
15713.0,372.0,6,985.99,1,3,3,7
15714.0,367.0,5,784.8100000000001,1,3,2,6
15715.0,673.0,5,658.02,1,3,2,6
15716.0,367.0,11,3056.81,1,4,4,9
15717.0,612.0,5,607.0,1,3,2,6
15718.0,0.0,1,293.79,4,1,1,6
15719.0,4.0,39,10134.36,3,4,4,11
15720.0,523.0,2,741.92,1,1,2,4
15721.0,0.0,1,507.08,4,1,2,7
15722.0,219.0,15,5120.05,2,4,4,10
15723.0,425.0,4,947.65,1,2,3,6
15724.0,69.0,5,299.8,3,3,1,7
15725.0,0.0,1,415.25,4,1,2,7
15726.0,0.0,1,321.91,4,1,1,6
15727.0,10.0,15,9445.51,3,4,4,11
15728.0,0.0,3,409.80000000000007,4,2,2,8
15729.0,36.0,5,154.70000000000002,3,3,1,7
15730.0,124.0,7,1708.18,2,3,3,8
15731.0,614.0,1,125.3,1,1,1,3
15732.0,36.0,12,1637.52,3,4,3,10
15733.0,311.0,1,162.3,2,1,1,4
15734.0,431.0,4,2263.3,1,2,4,7
15735.0,0.0,1,327.68,4,1,2,7
15736.0,579.0,3,1717.27,1,2,3,6
15737.0,37.0,12,1121.21,3,4,3,10
15738.0,69.0,45,13342.12,3,4,4,11
15739.0,245.0,1,449.12,2,1,2,5
15740.0,0.0,1,154.88,4,1,1,6
15741.0,520.0,2,208.62,1,1,1,3
15742.0,0.0,1,156.87,4,1,1,6
15743.0,127.0,4,784.46,2,2,2,6
15744.0,0.0,1,34.8,4,1,1,6
15745.0,183.0,6,1071.24,2,3,3,8
15746.0,0.0,2,182.96,4,1,1,6
15747.0,33.0,10,2560.66,3,4,4,11
15748.0,0.0,3,614.7600000000001,4,2,2,8
15749.0,40.0,4,21535.9,3,2,4,9
15750.0,152.0,24,6692.551,2,4,4,10
15751.0,526.0,14,1318.84,1,4,3,8
15752.0,155.0,10,4199.09,2,4,4,10
15753.0,131.0,1,79.2,2,1,1,4
15754.0,160.0,12,3001.86,2,4,4,10
15755.0,2.0,20,5936.95,3,4,4,11
15756.0,65.0,4,532.96,3,2,2,7
15757.0,189.0,6,2940.36,2,3,4,9
15758.0,0.0,1,205.25,4,1,1,6
15759.0,220.0,10,810.98,2,4,2,8
15760.0,0.0,5,-5795.87,4,3,1,8
15761.0,0.0,1,143.05,4,1,1,6
15762.0,215.0,2,583.75,2,1,2,5
15763.0,122.0,3,1048.67,2,2,3,7
15764.0,1.0,14,4453.28,3,4,4,11
15765.0,404.0,1,370.63,1,1,2,4
15766.0,184.0,4,799.66,2,2,2,6
15767.0,495.0,2,-242.70000000000002,1,1,1,3
15768.0,403.0,36,15559.46,1,4,4,9
15769.0,91.0,51,84269.38,3,4,4,11
15770.0,555.0,1,321.45,1,1,1,3
15771.0,555.0,3,1006.54,1,2,3,6
15772.0,0.0,1,280.88,4,1,1,6
15773.0,243.0,2,774.52,2,1,2,5
15774.0,304.0,7,1324.2,2,3,3,8
15775.0,129.0,2,150.5,2,1,1,4
15776.0,0.0,1,241.62,4,1,1,6
15777.0,7.0,9,1732.1599999999999,3,4,3,10
15778.0,610.0,1,307.95,1,1,1,3
15779.0,670.0,2,124.08000000000001,1,1,1,3
15780.0,37.0,3,475.28000000000003,3,2,2,7
15781.0,162.0,4,333.56,2,2,2,6
15782.0,32.0,6,3985.65,3,3,4,10
15783.0,0.0,1,246.3,4,1,1,6
15784.0,588.0,2,848.3299999999999,1,1,3,5
15785.0,61.0,26,5825.33,3,4,4,11
15786.0,368.0,9,8392.85,1,4,4,9
15787.0,92.0,3,948.05,3,2,3,8
15788.0,0.0,2,215.53,4,1,1,6
15789.0,610.0,7,1932.01,1,3,3,7
15790.0,0.0,1,220.85,4,1,1,6
15791.0,308.0,9,3541.79,2,4,4,10
15792.0,579.0,2,933.84,1,1,3,5
15793.0,489.0,9,2382.92,1,4,4,9
15794.0,1004.0,2,777.0,1,1,2,4
15795.0,580.0,8,1979.8700000000001,1,3,3,7
15796.0,39.0,22,5019.95,3,4,4,11
15797.0,97.0,6,2821.08,3,3,4,10
15798.0,612.0,3,1535.37,1,2,3,6
15799.0,101.0,4,1424.29,2,2,3,7
15800.0,160.0,7,1242.58,2,3,3,8
15801.0,62.0,4,1042.19,3,2,3,8
15802.0,0.0,3,-451.42,4,2,1,7
15803.0,670.0,4,1929.66,1,2,3,6
15804.0,90.0,19,3848.55,3,4,4,11
15805.0,61.0,40,9708.92,3,4,4,11
15806.0,130.0,3,784.58,2,2,2,6
15807.0,404.0,6,1807.57,1,3,3,7
15808.0,192.0,24,18248.83,2,4,4,10
15809.0,70.0,9,862.88,3,4,3,10
15810.0,306.0,13,2724.8,2,4,4,10
15811.0,161.0,10,3843.2200000000003,2,4,4,10
15812.0,34.0,13,5186.17,3,4,4,11
15813.0,0.0,2,1303.9099999999999,4,1,3,8
15814.0,61.0,8,2531.84,3,3,4,10
15815.0,36.0,5,2100.6,3,3,3,9
15816.0,0.0,3,93.3,4,2,1,7
15817.0,612.0,3,2766.4,1,2,4,7
15818.0,0.0,1,340.5,4,1,2,7
15819.0,130.0,11,3911.28,2,4,4,10
15820.0,0.0,1,206.98,4,1,1,6
15821.0,92.0,2,570.96,3,1,2,6
15822.0,182.0,8,1777.91,2,3,3,8
15823.0,193.0,6,3033.86,2,3,4,9
15824.0,367.0,2,890.94,1,1,3,5
15825.0,0.0,1,532.94,4,1,2,7
15826.0,0.0,6,2583.13,4,3,4,11
15827.0,36.0,42,3430.96,3,4,4,11
15828.0,0.0,1,1108.82,4,1,3,8
15829.0,336.0,2,636.14,2,1,2,5
15830.0,61.0,2,547.7,3,1,2,6
15831.0,1.0,4,747.76,3,2,2,7
15832.0,0.0,1,836.79,4,1,2,7
15833.0,1032.0,1,80.4,1,1,1,3
15834.0,160.0,9,3600.29,2,4,4,10
15835.0,0.0,4,954.09,4,2,3,9
15836.0,0.0,2,117.47,4,1,1,6
15837.0,184.0,2,777.01,2,1,2,5
15838.0,64.0,38,73404.11,3,4,4,11
15839.0,61.0,5,1020.74,3,3,3,9
15840.0,1.0,3,345.66,3,2,2,7
15841.0,183.0,12,2716.5,2,4,4,10
15842.0,395.0,3,528.75,1,2,2,5
15843.0,100.0,1,118.95000000000002,3,1,1,5
15844.0,0.0,1,130.73999999999998,4,1,1,6
15845.0,193.0,14,4273.65,2,4,4,10
15846.0,0.0,1,107.01,4,1,1,6
15847.0,334.0,5,822.57,2,3,2,7
15848.0,0.0,1,139.94,4,1,1,6
15849.0,0.0,1,-5876.34,4,1,1,6
15850.0,0.0,6,1058.72,4,3,3,10
15851.0,703.0,1,109.73,1,1,1,3
15852.0,188.0,3,257.26,2,2,1,5
15853.0,0.0,1,110.8,4,1,1,6
15854.0,213.0,21,5583.81,2,4,4,10
15855.0,96.0,6,1052.72,3,3,3,9
15856.0,34.0,58,33817.44,3,4,4,11
15857.0,580.0,2,570.48,1,1,2,4
15858.0,31.0,15,3917.87,3,4,4,11
15859.0,641.0,1,438.46,1,1,2,4
15860.0,156.0,17,2505.21,2,4,4,10
15861.0,457.0,15,4217.99,1,4,4,9
15862.0,333.0,13,2928.29,2,4,4,10
15863.0,706.0,5,358.7,1,3,2,6
15864.0,245.0,9,2014.22,2,4,3,9
15865.0,2.0,5,2248.92,3,3,4,10
15866.0,0.0,1,230.53,4,1,1,6
15867.0,37.0,35,8974.85,3,4,4,11
15868.0,585.0,1,94.53,1,1,1,3
15869.0,160.0,3,323.65999999999997,2,2,1,5
15870.0,153.0,4,862.61,2,2,3,7
15871.0,0.0,1,33.099999999999994,4,1,1,6
15872.0,523.0,4,795.68,1,2,2,5
15873.0,612.0,5,138.23999999999998,1,3,1,5
15874.0,129.0,25,11135.0,2,4,4,10
15875.0,648.0,1,111.72,1,1,1,3
15876.0,0.0,2,1449.1399999999999,4,1,3,8
15877.0,121.0,3,440.78,2,2,2,6
15878.0,912.0,2,330.77,1,1,2,4
15879.0,551.0,4,1157.3,1,2,3,6
15880.0,578.0,2,626.5600000000001,1,1,2,4
15881.0,425.0,8,438.24,1,3,2,6
15882.0,547.0,10,1448.91,1,4,3,8
15883.0,152.0,2,396.48,2,1,2,5
15884.0,641.0,3,243.75000000000003,1,2,1,4
15885.0,124.0,20,1737.57,2,4,3,9
15886.0,62.0,4,1052.8700000000001,3,2,3,8
15887.0,581.0,3,1027.15,1,2,3,6
15888.0,609.0,4,402.12,1,2,2,5
15889.0,187.0,9,1795.83,2,4,3,9
15890.0,426.0,5,535.65,1,3,2,6
15891.0,0.0,1,524.52,4,1,2,7
15892.0,496.0,1,128.2,1,1,1,3
15893.0,0.0,1,305.28000000000003,4,1,1,6
15894.0,578.0,2,420.29,1,1,2,4
15895.0,0.0,1,179.17,4,1,1,6
15896.0,0.0,1,-1899.67,4,1,1,6
15897.0,0.0,2,222.05,4,1,1,6
15898.0,121.0,29,5534.36,2,4,4,10
15899.0,547.0,1,112.5,1,1,1,3
15900.0,0.0,5,890.5,4,3,3,10
15901.0,126.0,9,684.23,2,4,2,8
15902.0,0.0,1,145.01,4,1,1,6
15903.0,30.0,15,8859.82,3,4,4,11
15904.0,333.0,1,164.68,2,1,1,4
15905.0,0.0,1,114.69,4,1,1,6
15906.0,250.0,12,2467.89,2,4,4,10
15907.0,182.0,3,967.45,2,2,3,7
15908.0,551.0,2,764.57,1,1,2,4
15909.0,0.0,1,191.94,4,1,1,6
15910.0,90.0,15,2681.8,3,4,4,11
15911.0,434.0,10,1401.55,1,4,3,8
15912.0,790.0,9,1074.7,1,4,3,8
15913.0,0.0,1,6.300000000000001,4,1,1,6
15914.0,0.0,2,205.99,4,1,1,6
15915.0,640.0,1,429.21,1,1,2,4
15916.0,91.0,17,3277.67,3,4,4,11
15917.0,190.0,5,560.63,2,3,2,7
15918.0,308.0,3,582.88,2,2,2,6
15919.0,547.0,2,910.61,1,1,3,5
15920.0,126.0,9,571.64,2,4,2,8
15921.0,464.0,4,802.11,1,2,2,5
15922.0,667.0,2,727.2,1,1,2,4
15923.0,667.0,1,254.16,1,1,1,3
15924.0,851.0,1,102.82,1,1,1,3
15925.0,0.0,1,207.15,4,1,1,6
15926.0,0.0,1,134.44,4,1,1,6
15927.0,676.0,1,123.39,1,1,1,3
15928.0,0.0,1,293.53,4,1,1,6
15929.0,587.0,1,594.0,1,1,2,4
15930.0,276.0,1,426.63,2,1,2,5
15931.0,519.0,1,239.9,1,1,1,3
15932.0,2.0,11,2461.85,3,4,4,11
15933.0,0.0,3,1107.46,4,2,3,9
15934.0,549.0,2,2190.66,1,1,4,6
15935.0,7.0,3,108.03999999999999,3,2,1,6
15936.0,0.0,2,282.79,4,1,1,6
15937.0,184.0,1,145.35,2,1,1,4
15938.0,221.0,9,734.81,2,4,2,8
15939.0,5.0,17,9047.64,3,4,4,11
15940.0,343.0,3,-3.552713678800501e-15,2,2,1,5
15941.0,373.0,2,230.6,1,1,1,3
15942.0,0.0,1,337.44,4,1,2,7
15943.0,0.0,2,271.28999999999996,4,1,1,6
15944.0,130.0,4,2164.24,2,2,3,7
15945.0,455.0,4,827.27,1,2,2,5
15946.0,0.0,3,2304.18,4,2,4,10
15947.0,0.0,1,1708.24,4,1,3,8
15948.0,333.0,3,1509.0900000000001,2,2,3,7
15949.0,0.0,2,364.72,4,1,2,7
15950.0,121.0,13,6938.51,2,4,4,10
15951.0,120.0,4,974.52,2,2,3,7
15952.0,183.0,4,806.57,2,2,2,6
15953.0,6.0,21,3524.7,3,4,4,11
15954.0,0.0,1,190.75,4,1,1,6
15955.0,31.0,25,8622.61,3,4,4,11
15956.0,553.0,2,617.6,1,1,2,4
15957.0,122.0,3,930.1,2,2,3,7
15958.0,523.0,4,492.99,1,2,2,5
15959.0,0.0,3,579.49,4,2,2,8
15960.0,426.0,5,394.0,1,3,2,6
15961.0,0.0,1,451.28999999999996,4,1,2,7
15962.0,0.0,1,295.83,4,1,1,6
15963.0,0.0,2,470.76,4,1,2,7
15964.0,0.0,1,272.96000000000004,4,1,1,6
15965.0,30.0,14,2999.34,3,4,4,11
15966.0,0.0,2,399.58,4,1,2,7
15967.0,496.0,13,3019.2,1,4,4,9
15968.0,0.0,1,418.05,4,1,2,7
15969.0,152.0,6,1043.85,2,3,3,8
15970.0,100.0,2,1017.32,3,1,3,7
15971.0,2.0,20,4930.43,3,4,4,11
15972.0,458.0,5,1810.27,1,3,3,7
15973.0,254.0,5,780.39,2,3,2,7
15974.0,6.0,8,3429.55,3,3,4,10
15975.0,0.0,1,371.01,4,1,2,7
15976.0,281.0,6,1746.6399999999999,2,3,3,8
15977.0,0.0,2,1054.73,4,1,3,8
15978.0,365.0,5,3272.62,2,3,4,9
15979.0,0.0,1,329.22,4,1,2,7
15980.0,2.0,9,6546.28,3,4,4,11
15981.0,7.0,27,9268.07,3,4,4,11
15982.0,0.0,1,324.51,4,1,1,6
15983.0,365.0,8,3958.8199999999997,2,3,4,9
15984.0,152.0,32,8671.12,2,4,4,10
15985.0,125.0,8,2610.28,2,3,4,9
15986.0,91.0,2,354.42,3,1,2,6
15987.0,33.0,8,1682.13,3,3,3,9
15988.0,553.0,3,770.09,1,2,2,5
15989.0,1032.0,2,372.51,1,1,2,4
15990.0,671.0,7,2010.05,1,3,3,7
15991.0,0.0,1,150.55,4,1,1,6
15992.0,182.0,3,896.6,2,2,3,7
15993.0,183.0,10,2756.82,2,4,4,10
15994.0,0.0,5,1198.84,4,3,3,10
15995.0,0.0,1,696.19,4,1,2,7
15996.0,2.0,8,1671.0,3,3,3,9
15997.0,706.0,1,-23.4,1,1,1,3
15998.0,275.0,21,8220.39,2,4,4,10
15999.0,973.0,1,20.4,1,1,1,3
16000.0,152.0,3,12393.7,2,2,4,8
16001.0,0.0,2,519.06,4,1,2,7
16002.0,0.0,1,169.21,4,1,1,6
16003.0,61.0,10,5613.83,3,4,4,11
16004.0,0.0,5,2146.39,4,3,3,10
16005.0,66.0,11,2403.77,3,4,4,11
16006.0,6.0,2,347.17,3,1,2,6
16007.0,5.0,7,3075.14,3,3,4,10
16008.0,367.0,15,5384.13,1,4,4,9
16009.0,153.0,4,992.71,2,2,3,7
16010.0,129.0,12,1722.1100000000001,2,4,3,9
16011.0,3.0,30,5867.01,3,4,4,11
16012.0,156.0,5,2989.79,2,3,4,9
16013.0,3.0,94,52788.92,3,4,4,11
16014.0,65.0,6,1121.02,3,3,3,9
16015.0,182.0,4,690.54,2,2,2,6
16016.0,182.0,14,2495.04,2,4,4,10
16017.0,589.0,5,1553.83,1,3,3,7
16018.0,5.0,4,698.13,3,2,2,7
16019.0,121.0,35,16640.15,2,4,4,10
16020.0,215.0,3,851.01,2,2,3,7
16021.0,456.0,2,532.25,1,1,2,4
16022.0,0.0,1,628.28,4,1,2,7
16023.0,0.0,3,719.81,4,2,2,8
16024.0,0.0,3,484.2,4,2,2,8
16025.0,61.0,1,439.65999999999997,3,1,2,6
16026.0,0.0,1,236.09,4,1,1,6
16027.0,70.0,18,1799.8400000000001,3,4,3,10
16028.0,0.0,1,82.2,4,1,1,6
16029.0,31.0,125,91800.91,3,4,4,11
16030.0,284.0,1,331.24,2,1,2,5
16031.0,124.0,2,548.94,2,1,2,5
16032.0,457.0,6,1970.45,1,3,3,7
16033.0,6.0,36,10692.39,3,4,4,11
16034.0,40.0,7,925.77,3,3,3,9
16035.0,0.0,1,217.73,4,1,1,6
16036.0,396.0,4,2556.84,1,2,4,7
16037.0,131.0,7,1489.44,2,3,3,8
16038.0,302.0,4,454.33000000000004,2,2,2,6
16039.0,366.0,3,449.65,1,2,2,5
16040.0,215.0,8,2383.7000000000003,2,3,4,9
16041.0,91.0,3,3166.4,3,2,4,9
16042.0,40.0,11,2153.0,3,4,3,10
16043.0,6.0,8,1856.5900000000001,3,3,3,9
16044.0,0.0,1,340.84000000000003,4,1,2,7
16045.0,3.0,9,3187.03,3,4,4,11
16046.0,0.0,1,235.78,4,1,1,6
16047.0,0.0,1,107.14,4,1,1,6
16048.0,492.0,6,1056.53,1,3,3,7
16049.0,399.0,6,1899.68,1,3,3,7
16050.0,640.0,3,300.7,1,2,1,4
16051.0,0.0,1,188.44,4,1,1,6
16052.0,0.0,1,362.06,4,1,2,7
16053.0,94.0,8,3606.14,3,3,4,10
16054.0,372.0,7,2090.68,1,3,3,7
16055.0,281.0,1,134.8,2,1,1,4
16056.0,0.0,1,664.85,4,1,2,7
16057.0,6.0,17,3202.07,3,4,4,11
16058.0,0.0,1,62.7,4,1,1,6
16059.0,215.0,12,3217.77,2,4,4,10
16060.0,580.0,3,541.95,1,2,2,5
16061.0,610.0,3,44.95,1,2,1,4
16062.0,7.0,8,2863.45,3,3,4,10
16063.0,0.0,1,335.32,4,1,2,7
16064.0,0.0,1,111.0,4,1,1,6
16065.0,455.0,10,2365.62,1,4,4,9
16066.0,92.0,5,1521.87,3,3,3,9
16067.0,588.0,6,3026.19,1,3,4,8
16068.0,0.0,1,122.93,4,1,1,6
16069.0,0.0,1,457.7,4,1,2,7
16070.0,153.0,2,852.15,2,1,3,6
16071.0,0.0,4,1076.8,4,2,3,9
16072.0,492.0,4,4328.89,1,2,4,7
16073.0,0.0,2,94.35,4,1,1,6
16074.0,0.0,1,265.25,4,1,1,6
16075.0,0.0,3,726.98,4,2,2,8
16076.0,31.0,11,2173.53,3,4,3,10
16077.0,0.0,2,600.0,4,1,2,7
16078.0,342.0,2,362.99,2,1,2,5
16079.0,0.0,3,1352.0,4,2,3,9
16080.0,69.0,6,472.9,3,3,2,8
16081.0,158.0,8,4460.18,2,3,4,9
16082.0,527.0,1,106.75,1,1,1,3
16083.0,0.0,4,2351.42,4,2,4,10
16084.0,0.0,1,436.18,4,1,2,7
16085.0,1.0,13,2337.73,3,4,4,11
16086.0,31.0,11,2862.91,3,4,4,11
16087.0,463.0,5,1739.92,1,3,3,7
16088.0,0.0,2,1437.43,4,1,3,8
16089.0,0.0,2,271.44,4,1,1,6
16090.0,0.0,1,205.91,4,1,1,6
16091.0,126.0,2,315.06,2,1,1,4
16092.0,158.0,10,1515.49,2,4,3,9
16093.0,0.0,1,17.0,4,1,1,6
16094.0,61.0,19,3599.16,3,4,4,11
16095.0,458.0,1,447.05,1,1,2,4
16096.0,617.0,4,1584.97,1,2,3,6
16097.0,0.0,1,185.04999999999998,4,1,1,6
16098.0,158.0,14,4448.1,2,4,4,10
16099.0,648.0,8,1568.25,1,3,3,7
16100.0,642.0,1,582.64,1,1,2,4
16101.0,700.0,7,3167.42,1,3,4,8
16102.0,278.0,3,1842.14,2,2,3,7
16103.0,188.0,27,6002.76,2,4,4,10
16104.0,92.0,11,2515.36,3,4,4,11
16105.0,221.0,5,2386.19,2,3,4,9
16106.0,215.0,1,108.38,2,1,1,4
16107.0,30.0,7,3204.1600000000003,3,3,4,10
16108.0,371.0,8,2171.93,1,3,3,7
16109.0,220.0,4,923.58,2,2,3,7
16110.0,343.0,4,1819.27,2,2,3,7
16111.0,518.0,1,562.48,1,1,2,4
16112.0,71.0,4,195.73999999999998,3,2,1,6
16113.0,96.0,1,161.38,3,1,1,5
16114.0,0.0,1,135.75000000000003,4,1,1,6
16115.0,5.0,12,2575.14,3,4,4,11
16116.0,6.0,2,592.88,3,1,2,6
16117.0,280.0,4,650.05,2,2,2,6
16118.0,394.0,5,4255.43,1,3,4,8
16119.0,333.0,8,1720.81,2,3,3,8
16120.0,31.0,7,3041.91,3,3,4,10
16121.0,128.0,6,1457.19,2,3,3,8
16122.0,40.0,6,1001.34,3,3,3,9
16123.0,0.0,1,307.78,4,1,1,6
16124.0,585.0,6,1709.39,1,3,3,7
16125.0,404.0,14,4587.65,1,4,4,9
16126.0,61.0,15,14646.800000000001,3,4,4,11
16127.0,0.0,2,801.31,4,1,2,7
16128.0,275.0,14,3748.4,2,4,4,10
16129.0,580.0,3,1396.05,1,2,3,6
16130.0,432.0,4,987.48,1,2,3,6
16131.0,427.0,15,9866.27,1,4,4,9
16132.0,0.0,2,664.1999999999999,4,1,2,7
16133.0,30.0,78,22228.88,3,4,4,11
16134.0,366.0,7,2119.99,1,3,3,7
16135.0,585.0,2,819.45,1,1,2,4
16136.0,31.0,5,921.08,3,3,3,9
16137.0,0.0,1,422.7,4,1,2,7
16138.0,547.0,4,894.45,1,2,3,6
16139.0,1004.0,5,1111.15,1,3,3,7
16140.0,215.0,5,1536.19,2,3,3,8
16141.0,2.0,2,955.94,3,1,3,7
16142.0,251.0,1,535.34,2,1,2,5
16143.0,36.0,16,4866.88,3,4,4,11
16144.0,160.0,1,175.2,2,1,1,4
16145.0,4.0,29,6693.6,3,4,4,11
16146.0,218.0,4,946.38,2,2,3,7
16147.0,588.0,7,2367.02,1,3,4,8
16148.0,0.0,4,370.37,4,2,2,8
16149.0,213.0,3,422.22,2,2,2,6
16150.0,2.0,20,4154.69,3,4,4,11
16151.0,0.0,1,-4217.59,4,1,1,6
16152.0,0.0,1,1829.04,4,1,3,8
16153.0,158.0,13,5037.51,2,4,4,10
16154.0,0.0,1,-10.5,4,1,1,6
16155.0,0.0,6,781.05,4,3,2,9
16156.0,34.0,26,5933.59,3,4,4,11
16157.0,0.0,4,644.24,4,2,2,8
16158.0,583.0,10,611.32,1,4,2,7
16159.0,283.0,5,1230.29,2,3,3,8
16160.0,183.0,4,1009.4499999999999,2,2,3,7
16161.0,31.0,57,12448.960000000001,3,4,4,11
16162.0,341.0,1,37.4,2,1,1,4
16163.0,400.0,14,2263.63,1,4,4,9
16164.0,334.0,4,802.53,2,2,2,6
16165.0,0.0,1,79.9,4,1,1,6
16166.0,519.0,4,327.48,1,2,2,5
16167.0,705.0,6,1149.8700000000001,1,3,3,7
16168.0,4.0,73,10539.08,3,4,4,11
16169.0,61.0,4,1822.97,3,2,3,8
16170.0,96.0,25,6813.67,3,4,4,11
16171.0,31.0,1,73.2,3,1,1,5
16172.0,7.0,8,1884.55,3,3,3,9
16173.0,93.0,7,1406.57,3,3,3,9
16174.0,34.0,7,2246.75,3,3,4,10
16175.0,185.0,7,1836.44,2,3,3,8
16176.0,0.0,7,1964.04,4,3,3,10
16177.0,457.0,12,2141.61,1,4,3,8
16178.0,640.0,2,612.6,1,1,2,4
16179.0,62.0,1,215.83,3,1,1,5
16180.0,33.0,16,16170.27,3,4,4,11
16181.0,0.0,1,305.54,4,1,1,6
16182.0,337.0,9,9971.65,2,4,4,10
16183.0,276.0,4,1077.81,2,2,3,7
16184.0,6.0,7,1155.54,3,3,3,9
16185.0,0.0,3,644.72,4,2,2,8
16186.0,6.0,30,8983.91,3,4,4,11
16187.0,1.0,17,6841.24,3,4,4,11
16188.0,37.0,6,1077.71,3,3,3,9
16189.0,0.0,2,215.48,4,1,1,6
16190.0,426.0,8,2723.55,1,3,4,8
16191.0,2.0,40,15162.12,3,4,4,11
16192.0,973.0,1,351.3,1,1,2,4
16193.0,0.0,2,630.43,4,1,2,7
16194.0,0.0,1,308.59999999999997,4,1,1,6
16195.0,0.0,1,323.25,4,1,1,6
16196.0,490.0,1,93.3,1,1,1,3
16197.0,522.0,9,2016.71,1,4,3,8
16198.0,0.0,2,1030.0410000000002,4,1,3,8
16199.0,365.0,7,942.75,2,3,3,8
16200.0,213.0,13,5629.95,2,4,4,10
16201.0,182.0,6,2070.17,2,3,3,8
16202.0,645.0,11,2467.04,1,4,4,9
16203.0,1.0,7,1110.79,3,3,3,9
16204.0,850.0,4,939.24,1,2,3,6
16205.0,91.0,7,1830.61,3,3,3,9
16206.0,156.0,14,2597.37,2,4,4,10
16207.0,0.0,1,394.38,4,1,2,7
16208.0,367.0,10,3440.45,1,4,4,9
16209.0,2.0,9,4146.78,3,4,4,11
16210.0,67.0,37,38304.06,3,4,4,11
16211.0,2.0,4,1086.34,3,2,3,8
16212.0,283.0,5,1284.56,2,3,3,8
16213.0,0.0,1,159.0,4,1,1,6
16214.0,341.0,4,2038.25,2,2,3,7
16215.0,0.0,1,242.35,4,1,1,6
16216.0,0.0,1,914.9300000000001,4,1,3,8
16217.0,129.0,4,259.39000000000004,2,2,1,5
16218.0,61.0,19,4343.6,3,4,4,11
16219.0,0.0,1,40.8,4,1,1,6
16220.0,759.0,1,-10.17,1,1,1,3
16221.0,99.0,10,2229.0099999999998,3,4,4,11
16222.0,0.0,2,1345.22,4,1,3,8
16223.0,456.0,2,1102.3500000000001,1,1,3,5
16224.0,251.0,5,1616.54,2,3,3,8
16225.0,161.0,18,2821.9100000000003,2,4,4,10
16226.0,0.0,5,672.1700000000001,4,3,2,9
16227.0,250.0,6,948.82,2,3,3,8
16228.0,608.0,4,886.1600000000001,1,2,3,6
16229.0,36.0,7,2835.36,3,3,4,10
16230.0,280.0,2,542.03,2,1,2,5
16231.0,395.0,4,1078.22,1,2,3,6
16232.0,128.0,10,2692.02,2,4,4,10
16233.0,486.0,12,1818.71,1,4,3,8
16234.0,0.0,4,312.78,4,2,1,7
16235.0,40.0,11,1990.6100000000001,3,4,3,10
16236.0,0.0,1,432.2,4,1,2,7
16237.0,0.0,1,136.65,4,1,1,6
16238.0,0.0,1,63.66,4,1,1,6
16239.0,280.0,7,1450.9,2,3,3,8
16240.0,333.0,5,3693.81,2,3,4,9
16241.0,1.0,16,4329.31,3,4,4,11
16242.0,97.0,18,7433.3,3,4,4,11
16243.0,183.0,2,409.1,2,1,2,5
16244.0,6.0,2,2579.38,3,1,4,8
16245.0,64.0,5,1352.3600000000001,3,3,3,9
16246.0,496.0,2,827.25,1,1,2,4
16247.0,0.0,1,114.56,4,1,1,6
16248.0,92.0,1,152.94,3,1,1,5
16249.0,0.0,5,1800.07,4,3,3,10
16250.0,698.0,3,791.38,1,2,2,5
16251.0,0.0,1,128.31,4,1,1,6
16252.0,486.0,2,-295.09,1,1,1,3
16253.0,122.0,9,7276.91,2,4,4,10
16254.0,0.0,3,985.14,4,2,3,9
16255.0,125.0,19,4834.39,2,4,4,10
16256.0,643.0,4,1609.57,1,2,3,6
16257.0,0.0,1,46.95,4,1,1,6
16258.0,247.0,16,11833.52,2,4,4,10
16259.0,0.0,3,361.94,4,2,2,8
16260.0,0.0,1,1035.45,4,1,3,8
16261.0,159.0,6,1059.45,2,3,3,8
16262.0,0.0,3,677.78,4,2,2,8
16263.0,366.0,1,351.01,1,1,2,4
16264.0,0.0,2,837.53,4,1,2,7
16265.0,39.0,15,6893.62,3,4,4,11
16266.0,365.0,14,1757.95,2,4,3,9
16267.0,0.0,1,186.66,4,1,1,6
16268.0,0.0,2,667.65,4,1,2,7
16269.0,519.0,2,714.59,1,1,2,4
16270.0,0.0,1,1141.24,4,1,3,8
16271.0,152.0,11,3457.07,2,4,4,10
16272.0,0.0,1,411.7,4,1,2,7
16273.0,707.0,2,336.03999999999996,1,1,2,4
16274.0,698.0,1,715.9,1,1,2,4
16275.0,495.0,3,2151.11,1,2,3,6
16276.0,402.0,3,2629.3900000000003,1,2,4,7
16277.0,912.0,1,188.69,1,1,1,3
16278.0,185.0,7,1056.59,2,3,3,8
16279.0,71.0,10,5692.18,3,4,4,11
16280.0,0.0,1,238.05,4,1,1,6
16281.0,366.0,4,3416.52,1,2,4,7
16282.0,254.0,3,1307.58,2,2,3,7
16283.0,33.0,12,4311.37,3,4,4,11
16284.0,122.0,3,1029.77,2,2,3,7
16285.0,648.0,1,176.9,1,1,1,3
16286.0,432.0,4,263.65,1,2,1,4
16287.0,495.0,5,1006.98,1,3,3,7
16288.0,0.0,1,129.85,4,1,1,6
16289.0,642.0,2,98.81,1,1,1,3
16290.0,701.0,4,2069.3,1,2,3,6
16291.0,0.0,1,117.72,4,1,1,6
16292.0,64.0,9,1171.46,3,4,3,10
16293.0,93.0,19,4632.2,3,4,4,11
16294.0,0.0,1,126.05000000000001,4,1,1,6
16295.0,1.0,4,1328.55,3,2,3,8
16296.0,527.0,6,1245.97,1,3,3,7
16297.0,36.0,4,275.4,3,2,1,6
16298.0,188.0,9,1080.0,2,4,3,9
16299.0,0.0,2,178.65,4,1,1,6
16300.0,580.0,3,1392.43,1,2,3,6
16301.0,1004.0,1,107.33,1,1,1,3
16302.0,217.0,2,212.82,2,1,1,4
16303.0,71.0,9,7823.72,3,4,4,11
16304.0,0.0,1,381.66,4,1,2,7
16305.0,0.0,1,361.21999999999997,4,1,2,7
16306.0,39.0,10,1162.82,3,4,3,10
16307.0,401.0,3,1194.92,1,2,3,6
16308.0,189.0,7,5120.0,2,3,4,9
16309.0,93.0,3,686.67,3,2,2,7
16310.0,526.0,2,460.08,1,1,2,4
16311.0,0.0,2,616.26,4,1,2,7
16312.0,641.0,1,171.15,1,1,1,3
16313.0,182.0,2,274.15000000000003,2,1,1,4
16314.0,520.0,3,1491.4,1,2,3,6
16315.0,0.0,2,402.71,4,1,2,7
16316.0,99.0,19,5533.31,3,4,4,11
16317.0,3.0,6,2179.76,3,3,3,9
16318.0,244.0,1,328.15,2,1,2,5
16319.0,189.0,1,404.40000000000003,2,1,2,5
16320.0,67.0,8,4428.849999999999,3,3,4,10
16321.0,162.0,10,265.5,2,4,1,7
16322.0,121.0,2,326.75,2,1,2,5
16323.0,401.0,2,353.66,1,1,2,4
16324.0,278.0,3,428.68,2,2,2,6
16325.0,129.0,17,3463.84,2,4,4,10
16326.0,92.0,26,4706.99,3,4,4,11
16327.0,578.0,20,10705.52,1,4,4,9
16328.0,0.0,1,310.83,4,1,1,6
16329.0,488.0,4,1703.07,1,2,3,6
16330.0,396.0,8,624.63,1,3,2,6
16331.0,526.0,6,2037.7,1,3,3,7
16332.0,30.0,13,1989.97,3,4,3,10
16333.0,125.0,22,26626.8,2,4,4,10
16334.0,612.0,1,277.48,1,1,1,3
16335.0,553.0,8,2747.0,1,3,4,8
16336.0,520.0,4,3517.69,1,2,4,7
16337.0,275.0,1,151.05,2,1,1,4
16338.0,218.0,1,214.79999999999998,2,1,1,4
16339.0,0.0,1,109.95,4,1,1,6
16340.0,553.0,3,1526.06,1,2,3,6
16341.0,463.0,10,3832.29,1,4,4,9
16342.0,0.0,4,322.41,4,2,1,7
16343.0,0.0,3,687.0699999999999,4,2,2,8
16344.0,248.0,4,842.42,2,2,2,6
16345.0,0.0,2,1198.74,4,1,3,8
16346.0,0.0,1,224.51,4,1,1,6
16347.0,275.0,13,3482.01,2,4,4,10
16348.0,153.0,8,1798.22,2,3,3,8
16349.0,0.0,1,53.5,4,1,1,6
16350.0,71.0,12,2206.49,3,4,4,11
16351.0,40.0,18,3279.13,3,4,4,11
16352.0,303.0,2,494.44,2,1,2,5
16353.0,10.0,41,9985.93,3,4,4,11
16354.0,154.0,5,1129.51,2,3,3,8
16355.0,0.0,2,349.2,4,1,2,7
16356.0,161.0,7,414.42,2,3,2,7
16357.0,67.0,4,868.37,3,2,3,8
16358.0,66.0,6,2917.1,3,3,4,10
16359.0,10.0,20,2379.4,3,4,4,11
16360.0,2.0,8,3411.69,3,3,4,10
16361.0,0.0,4,896.66,4,2,3,9
16362.0,31.0,11,841.74,3,4,2,9
16363.0,0.0,1,109.36000000000001,4,1,1,6
16364.0,0.0,2,707.04,4,1,2,7
16365.0,4.0,16,3296.7999999999997,3,4,4,11
16366.0,554.0,4,1548.1299999999999,1,2,3,6
16367.0,303.0,3,1362.4,2,2,3,7
16368.0,30.0,3,640.21,3,2,2,7
16369.0,525.0,7,2664.81,1,3,4,8
16370.0,66.0,4,1320.56,3,2,3,8
16371.0,0.0,1,157.2,4,1,1,6
16372.0,183.0,6,1298.61,2,3,3,8
16373.0,0.0,2,309.49,4,1,1,6
16374.0,245.0,5,1771.45,2,3,3,8
16375.0,0.0,2,104.0,4,1,1,6
16376.0,333.0,3,977.52,2,2,3,7
16377.0,706.0,2,1308.48,1,1,3,5
16378.0,190.0,3,362.95,2,2,2,6
16379.0,122.0,5,2131.9,2,3,3,8
16380.0,92.0,1,1780.59,3,1,3,7
16381.0,456.0,2,258.7,1,1,1,3
16382.0,523.0,2,353.1,1,1,2,4
16383.0,487.0,9,2910.84,1,4,4,9
16384.0,32.0,4,1358.95,3,2,3,8
16385.0,62.0,5,1030.61,3,3,3,9
16386.0,30.0,3,1102.59,3,2,3,8
16387.0,367.0,5,918.55,1,3,3,7
16388.0,0.0,1,186.05,4,1,1,6
16389.0,342.0,5,1362.27,2,3,3,8
16390.0,0.0,3,467.5,4,2,2,8
16391.0,609.0,4,1103.61,1,2,3,6
16392.0,0.0,3,763.05,4,2,2,8
16393.0,128.0,30,5456.5,2,4,4,10
16394.0,183.0,9,1412.06,2,4,3,9
16395.0,62.0,17,3458.95,3,4,4,11
16396.0,0.0,3,102.69999999999999,4,2,1,7
16397.0,0.0,1,127.88,4,1,1,6
16398.0,126.0,4,1631.15,2,2,3,7
16399.0,0.0,3,641.82,4,2,2,8
16400.0,185.0,9,3159.44,2,4,4,10
16401.0,94.0,39,6628.99,3,4,4,11
16402.0,578.0,2,511.4,1,1,2,4
16403.0,70.0,2,161.04999999999998,3,1,1,5
16404.0,882.0,2,430.3,1,1,2,4
16405.0,70.0,2,167.25,3,1,1,5
16406.0,0.0,4,533.98,4,2,2,8
16407.0,37.0,14,2821.65,3,4,4,11
16408.0,0.0,1,231.93,4,1,1,6
16409.0,4.0,12,5709.04,3,4,4,11
16410.0,943.0,1,130.32,1,1,1,3
16411.0,519.0,4,910.1899999999999,1,2,3,6
16412.0,395.0,5,647.23,1,3,2,6
16413.0,0.0,2,528.98,4,1,2,7
16414.0,252.0,5,559.71,2,3,2,7
16415.0,585.0,3,719.44,1,2,2,5
16416.0,153.0,10,2948.47,2,4,4,10
16417.0,612.0,1,35.7,1,1,1,3
16418.0,124.0,5,1101.94,2,3,3,8
16419.0,38.0,9,1474.67,3,4,3,10
16420.0,487.0,1,75.0,1,1,1,3
16421.0,0.0,3,526.27,4,2,2,8
16422.0,4.0,146,61110.54,3,4,4,11
16423.0,0.0,1,346.12,4,1,2,7
16424.0,193.0,3,392.06,2,2,2,6
16425.0,70.0,1,302.7,3,1,1,5
16426.0,124.0,10,1908.25,2,4,3,9
16427.0,0.0,2,241.06,4,1,1,6
16428.0,0.0,4,657.33,4,2,2,8
16429.0,0.0,1,284.55,4,1,1,6
16430.0,518.0,7,1117.94,1,3,3,7
16431.0,67.0,3,642.81,3,2,2,7
16432.0,184.0,1,287.4,2,1,1,4
16433.0,30.0,2,384.52,3,1,2,6
16434.0,61.0,13,2727.04,3,4,4,11
16435.0,0.0,3,1011.5699999999999,4,2,3,9
16436.0,465.0,4,242.04,1,2,1,4
16437.0,549.0,2,301.25,1,1,1,3
16438.0,243.0,5,798.35,2,3,2,7
16439.0,0.0,1,310.70000000000005,4,1,1,6
16440.0,61.0,6,3856.9700000000003,3,3,4,10
16441.0,275.0,6,1023.48,2,3,3,8
16442.0,121.0,5,899.47,2,3,3,8
16443.0,522.0,1,162.24,1,1,1,3
16444.0,216.0,20,3582.38,2,4,4,10
16445.0,183.0,4,602.73,2,2,2,6
16446.0,90.0,4,-6.100000000005821,3,2,1,6
16447.0,0.0,3,775.14,4,2,2,8
16448.0,0.0,2,367.87,4,1,2,7
16449.0,252.0,3,674.69,2,2,2,6
16450.0,615.0,4,1475.73,1,2,3,6
16451.0,851.0,4,1009.4,1,2,3,6
16452.0,0.0,2,332.17,4,1,2,7
16453.0,461.0,2,251.71,1,1,1,3
16454.0,184.0,8,1.9000000000000004,2,3,1,6
16455.0,154.0,13,4306.72,2,4,4,10
16456.0,192.0,14,6185.41,2,4,4,10
16457.0,220.0,1,208.36,2,1,1,4
16458.0,2.0,30,5715.34,3,4,4,11
16459.0,790.0,1,71.78999999999999,1,1,1,3
16460.0,30.0,3,814.72,3,2,2,7
16461.0,648.0,3,1615.22,1,2,3,6
16462.0,158.0,4,102.0,2,2,1,5
16463.0,244.0,7,1383.7,2,3,3,8
16464.0,0.0,3,1314.68,4,2,3,9
16465.0,0.0,3,726.34,4,2,2,8
16466.0,5.0,16,3713.59,3,4,4,11
16467.0,558.0,8,2862.4,1,3,4,8
16468.0,0.0,3,787.52,4,2,2,8
16469.0,160.0,5,828.91,2,3,2,7
16470.0,459.0,12,2453.65,1,4,4,9
16471.0,69.0,6,1186.18,3,3,3,9
16472.0,700.0,2,789.6,1,1,2,4
16473.0,163.0,5,469.58,2,3,2,7
16474.0,32.0,11,1811.47,3,4,3,10
16475.0,2.0,4,544.3,3,2,2,7
16476.0,396.0,3,337.0,1,2,2,5
16477.0,69.0,11,4320.02,3,4,4,11
16478.0,184.0,3,331.0,2,2,2,6
16479.0,0.0,2,300.83,4,1,1,6
16480.0,0.0,1,769.29,4,1,2,7
16481.0,0.0,3,428.23,4,2,2,8
16482.0,0.0,1,220.62,4,1,1,6
16483.0,0.0,1,139.35,4,1,1,6
16484.0,280.0,3,379.4,2,2,2,6
16485.0,641.0,7,2137.68,1,3,3,7
16486.0,0.0,1,134.36,4,1,1,6
16487.0,401.0,2,209.4,1,1,1,3
16488.0,183.0,4,492.2,2,2,2,6
16489.0,0.0,2,303.7,4,1,1,6
16490.0,579.0,2,179.16000000000003,1,1,1,3
16491.0,609.0,3,1524.31,1,2,3,6
16492.0,0.0,1,385.56,4,1,2,7
16493.0,583.0,9,2110.12,1,4,3,8
16494.0,0.0,1,826.53,4,1,2,7
16495.0,130.0,3,684.41,2,2,2,6
16496.0,333.0,7,2293.47,2,3,4,9
16497.0,71.0,23,6695.28,3,4,4,11
16498.0,338.0,3,86.12,2,2,1,5
16499.0,400.0,13,2491.7400000000002,1,4,4,9
16500.0,213.0,10,835.96,2,4,2,8
16501.0,0.0,1,1237.23,4,1,3,8
16502.0,0.0,2,266.5,4,1,1,6
16503.0,97.0,13,3597.89,3,4,4,11
16504.0,0.0,1,484.38,4,1,2,7
16505.0,122.0,1,777.6,2,1,2,5
16506.0,0.0,2,90.30000000000001,4,1,1,6
16507.0,0.0,1,152.76,4,1,1,6
16508.0,0.0,1,248.8,4,1,1,6
16509.0,0.0,1,363.7,4,1,2,7
16510.0,667.0,6,2100.0,1,3,3,7
16511.0,518.0,6,1819.02,1,3,3,7
16512.0,759.0,1,-33.9,1,1,1,3
16513.0,213.0,4,874.59,2,2,3,7
16514.0,0.0,1,-134.86,4,1,1,6
16515.0,4.0,10,3216.3,3,4,4,11
16516.0,91.0,1,101.69999999999999,3,1,1,5
16517.0,161.0,1,162.7,2,1,1,4
16518.0,92.0,6,938.27,3,3,3,9
16519.0,398.0,4,556.26,1,2,2,5
16520.0,188.0,8,2465.92,2,3,4,9
16521.0,707.0,3,1148.01,1,2,3,6
16522.0,0.0,2,433.36,4,1,2,7
16523.0,32.0,39,11760.54,3,4,4,11
16524.0,0.0,2,308.14,4,1,1,6
16525.0,10.0,54,23350.74,3,4,4,11
16526.0,615.0,2,717.21,1,1,2,4
16527.0,396.0,2,1272.44,1,1,3,5
16528.0,182.0,1,244.41,2,1,1,4
16529.0,307.0,4,2012.0,2,2,3,7
16530.0,465.0,1,48.349999999999994,1,1,1,3
16531.0,247.0,12,2263.58,2,4,4,10
16532.0,224.0,5,8756.64,2,3,4,9
16533.0,304.0,5,1026.94,2,3,3,8
16534.0,526.0,1,635.9,1,1,2,4
16535.0,243.0,3,1001.59,2,2,3,7
16536.0,0.0,2,539.02,4,1,2,7
16537.0,495.0,1,23.35,1,1,1,3
16538.0,0.0,3,399.62,4,2,2,8
16539.0,152.0,10,3732.01,2,4,4,10
16540.0,0.0,1,226.70000000000002,4,1,1,6
16541.0,973.0,2,419.78,1,1,2,4
16542.0,640.0,2,257.32,1,1,1,3
16543.0,585.0,2,277.80999999999995,1,1,1,3
16544.0,491.0,6,110.3,1,3,1,5
16545.0,0.0,2,689.82,4,1,2,7
16546.0,394.0,7,3837.36,1,3,4,8
16547.0,400.0,1,111.71,1,1,1,3
16548.0,0.0,1,30.15,4,1,1,6
16549.0,32.0,37,13159.64,3,4,4,11
16550.0,156.0,29,9169.32,2,4,4,10
16551.0,163.0,7,2237.12,2,3,4,9
16552.0,37.0,2,475.02000000000004,3,1,2,6
16553.0,7.0,36,16555.87,3,4,4,11
16554.0,10.0,18,2407.17,3,4,4,11
16555.0,244.0,10,285.89,2,4,1,7
16556.0,129.0,24,7610.2300000000005,2,4,4,10
16557.0,0.0,2,281.85,4,1,1,6
16558.0,7.0,47,13718.960000000001,3,4,4,11
16559.0,518.0,1,185.20000000000002,1,1,1,3
16560.0,518.0,10,3010.73,1,4,4,9
16561.0,31.0,2,511.12,3,1,2,6
16562.0,0.0,1,223.85999999999999,4,1,1,6
16563.0,458.0,7,4412.56,1,3,4,8
16564.0,0.0,1,87.8,4,1,1,6
16565.0,425.0,5,700.45,1,3,2,6
16566.0,308.0,6,614.01,2,3,2,7
16567.0,163.0,2,865.6,2,1,3,6
16568.0,488.0,2,1020.9000000000001,1,1,3,5
16569.0,182.0,5,1455.23,2,3,3,8
16570.0,153.0,31,6841.82,2,4,4,10
16571.0,182.0,17,4025.05,2,4,4,10
16572.0,34.0,4,999.7,3,2,3,8
16573.0,311.0,4,648.41,2,2,2,6
16574.0,366.0,3,1301.78,1,2,3,6
16575.0,0.0,1,-10.49,4,1,1,6
16576.0,552.0,5,513.1700000000001,1,3,2,6
16577.0,404.0,1,380.0,1,1,2,4
16578.0,0.0,1,156.6,4,1,1,6
16579.0,427.0,2,233.85,1,1,1,3
16580.0,759.0,1,-5.0,1,1,1,3
16581.0,66.0,2,70.44,3,1,1,5
16582.0,0.0,1,313.62,4,1,1,6
16583.0,618.0,2,531.4,1,1,2,4
16584.0,160.0,7,3085.4700000000003,2,3,4,9
16585.0,0.0,2,341.59,4,1,2,7
16586.0,221.0,3,1462.78,2,2,3,7
16587.0,0.0,1,225.15,4,1,1,6
16588.0,519.0,4,1361.28,1,2,3,6
16589.0,338.0,4,612.36,2,2,2,6
16590.0,609.0,3,563.6,1,2,2,5
16591.0,304.0,1,213.5,2,1,1,4
16592.0,91.0,34,7624.46,3,4,4,11
16593.0,280.0,9,1051.24,2,4,3,9
16594.0,0.0,1,181.09,4,1,1,6
16595.0,92.0,5,1810.18,3,3,3,9
16596.0,486.0,4,579.63,1,2,2,5
16597.0,213.0,1,90.04,2,1,1,4
16598.0,161.0,2,140.7,2,1,1,4
16599.0,0.0,1,172.8,4,1,1,6
16600.0,213.0,16,2093.56,2,4,3,9
16601.0,0.0,3,684.25,4,2,2,8
16602.0,122.0,5,711.63,2,3,2,7
16603.0,93.0,2,482.47,3,1,2,6
16604.0,461.0,3,326.25,1,2,2,5
16605.0,0.0,1,60.48,4,1,1,6
16606.0,700.0,2,357.66,1,1,2,4
16607.0,1.0,29,5375.18,3,4,4,11
16608.0,367.0,2,1288.72,1,1,3,5
16609.0,4.0,9,5450.96,3,4,4,11
16610.0,250.0,1,75.66,2,1,1,4
16611.0,188.0,7,1776.63,2,3,3,8
16612.0,3.0,10,3243.48,3,4,4,11
16613.0,0.0,1,618.59,4,1,2,7
16614.0,66.0,3,1179.79,3,2,3,8
16615.0,0.0,2,264.5,4,1,1,6
16616.0,218.0,2,500.42,2,1,2,5
16617.0,0.0,1,151.85,4,1,1,6
16618.0,122.0,6,2630.64,2,3,4,9
16619.0,0.0,5,1916.53,4,3,3,10
16620.0,182.0,6,1758.93,2,3,3,8
16621.0,128.0,4,813.48,2,2,2,6
16622.0,0.0,2,205.6,4,1,1,6
16623.0,129.0,5,1002.49,2,3,3,8
16624.0,0.0,2,810.5699999999999,4,1,2,7
16625.0,69.0,6,1651.08,3,3,3,9
16626.0,90.0,20,4379.65,3,4,4,11
16627.0,0.0,1,322.8,4,1,1,6
16628.0,61.0,8,2313.09,3,3,4,10
16629.0,246.0,2,417.73,2,1,2,5
16630.0,0.0,2,104.30000000000001,4,1,1,6
16631.0,401.0,8,1867.02,1,3,3,7
16632.0,398.0,2,406.4,1,1,2,4
16633.0,5.0,7,2878.15,3,3,4,10
16634.0,340.0,10,1363.1,2,4,3,9
16635.0,0.0,1,473.0,4,1,2,7
16636.0,554.0,4,3802.04,1,2,4,7
16637.0,62.0,5,1124.59,3,3,3,9
16638.0,161.0,16,2426.28,2,4,4,10
16639.0,122.0,5,1659.85,2,3,3,8
16640.0,518.0,1,179.4,1,1,1,3
16641.0,528.0,2,554.5,1,1,2,4
16642.0,213.0,5,1051.46,2,3,3,8
16643.0,129.0,3,915.5600000000001,2,2,3,7
16644.0,36.0,2,833.78,3,1,2,6
16645.0,973.0,1,160.39,1,1,1,3
16646.0,0.0,2,675.05,4,1,2,7
16647.0,0.0,4,541.9,4,2,2,8
16648.0,334.0,4,653.0,2,2,2,6
16649.0,522.0,1,306.58000000000004,1,1,1,3
16650.0,368.0,7,1916.11,1,3,3,7
16651.0,674.0,1,136.2,1,1,1,3
16652.0,1.0,24,17312.83,3,4,4,11
16653.0,184.0,3,1166.92,2,2,3,7
16654.0,219.0,9,1705.17,2,4,3,9
16655.0,10.0,14,6513.27,3,4,4,11
16656.0,4.0,44,16307.72,3,4,4,11
16657.0,0.0,4,933.62,4,2,3,9
16658.0,547.0,9,696.72,1,4,2,7
16659.0,280.0,1,39.12,2,1,1,4
16660.0,520.0,8,1422.35,1,3,3,7
16661.0,432.0,5,842.1800000000001,1,3,2,6
16662.0,426.0,1,163.8,1,1,1,3
16663.0,790.0,1,165.0,1,1,1,3
16664.0,0.0,1,109.2,4,1,1,6
16665.0,364.0,1,135.39999999999998,2,1,1,4
16666.0,0.0,2,225.94,4,1,1,6
16667.0,304.0,2,570.13,2,1,2,5
16668.0,66.0,13,862.42,3,4,3,10
16669.0,0.0,5,226.14000000000001,4,3,1,8
16670.0,1.0,33,7786.66,3,4,4,11
16671.0,30.0,3,1692.27,3,2,3,8
16672.0,7.0,23,8093.59,3,4,4,11
16673.0,0.0,1,188.83,4,1,1,6
16674.0,305.0,2,319.61,2,1,1,4
16675.0,0.0,2,608.86,4,1,2,7
16676.0,67.0,7,2328.5,3,3,4,10
16677.0,394.0,3,849.77,1,2,3,6
16678.0,3.0,17,3013.83,3,4,4,11
16679.0,426.0,3,793.06,1,2,2,5
16680.0,0.0,3,821.45,4,2,2,8
16681.0,495.0,7,1921.84,1,3,3,7
16682.0,124.0,5,1028.0,2,3,3,8
16683.0,0.0,2,309.35,4,1,1,6
16684.0,95.0,65,141502.25,3,4,4,11
16685.0,92.0,2,324.24,3,1,1,5
16686.0,162.0,18,5051.57,2,4,4,10
16687.0,0.0,1,157.63,4,1,1,6
16688.0,62.0,4,1260.86,3,2,3,8
16689.0,0.0,3,303.26,4,2,1,7
16690.0,395.0,5,336.08,1,3,2,6
16691.0,0.0,2,178.83,4,1,1,6
16692.0,0.0,4,1914.6999999999998,4,2,3,9
16693.0,304.0,5,1199.46,2,3,3,8
16694.0,0.0,1,98.30000000000001,4,1,1,6
16695.0,0.0,2,193.15,4,1,1,6
16696.0,67.0,4,657.9000000000001,3,2,2,7
16697.0,7.0,1,112.75,3,1,1,5
16698.0,0.0,2,1998.0,4,1,3,8
16699.0,973.0,8,964.9,1,3,3,7
16700.0,4.0,31,9084.06,3,4,4,11
16701.0,4.0,34,9614.59,3,4,4,11
16702.0,644.0,5,1100.8799999999999,1,3,3,7
16703.0,851.0,1,-15.0,1,1,1,3
16704.0,588.0,2,695.66,1,1,2,4
16705.0,1.0,61,42653.141,3,4,4,11
16706.0,303.0,3,531.35,2,2,2,6
16707.0,461.0,4,551.11,1,2,2,5
16708.0,0.0,1,656.63,4,1,2,7
16709.0,129.0,14,9087.460000000001,2,4,4,10
16710.0,67.0,23,6336.34,3,4,4,11
16711.0,70.0,10,2751.48,3,4,4,11
16712.0,36.0,13,4266.99,3,4,4,11
16713.0,1.0,41,14380.54,3,4,4,11
16714.0,220.0,7,1254.71,2,3,3,8
16715.0,0.0,2,625.52,4,1,2,7
16716.0,70.0,4,1568.2800000000002,3,2,3,8
16717.0,153.0,20,6309.96,2,4,4,10
16718.0,402.0,5,3647.53,1,3,4,8
16719.0,224.0,17,3828.55,2,4,4,10
16720.0,0.0,4,593.43,4,2,2,8
16721.0,0.0,1,292.47,4,1,1,6
16722.0,96.0,26,8967.83,3,4,4,11
16723.0,93.0,4,1301.63,3,2,3,8
16724.0,0.0,1,147.35,4,1,1,6
16725.0,70.0,16,1870.71,3,4,3,10
16726.0,0.0,7,2088.41,4,3,3,10
16727.0,365.0,4,1437.42,2,2,3,7
16728.0,0.0,4,1054.67,4,2,3,9
16729.0,7.0,26,7076.28,3,4,4,11
16730.0,39.0,4,702.79,3,2,2,7
16731.0,707.0,1,174.05,1,1,1,3
16732.0,122.0,9,3966.79,2,4,4,10
16733.0,0.0,1,259.68,4,1,1,6
16734.0,0.0,3,650.51,4,2,2,8
16735.0,101.0,22,5632.01,2,4,4,10
16736.0,615.0,8,2904.51,1,3,4,8
16737.0,401.0,2,835.1999999999999,1,1,2,4
16738.0,0.0,1,3.75,4,1,1,6
16739.0,0.0,4,772.23,4,2,2,8
16740.0,456.0,1,236.81,1,1,1,3
16741.0,0.0,1,173.06,4,1,1,6
16742.0,402.0,15,2387.71,1,4,4,9
16743.0,6.0,15,4207.01,3,4,4,11
16744.0,183.0,7,1304.76,2,3,3,8
16745.0,3.0,18,7170.7,3,4,4,11
16746.0,3.0,46,18031.85,3,4,4,11
16747.0,183.0,4,826.96,2,2,2,6
16748.0,101.0,15,3632.29,2,4,4,10
16749.0,0.0,2,4387.08,4,1,4,9
16750.0,64.0,5,623.93,3,3,2,8
16751.0,91.0,1,1764.72,3,1,3,7
16752.0,667.0,1,415.0,1,1,2,4
16753.0,1.0,1,223.92000000000002,3,1,1,5
16754.0,372.0,35,56560.58,1,4,4,9
16755.0,649.0,10,2882.03,1,4,4,9
16756.0,97.0,9,1287.42,3,4,3,10
16757.0,0.0,2,270.48,4,1,1,6
16758.0,215.0,1,369.34000000000003,2,1,2,5
16759.0,91.0,4,772.84,3,2,2,7
16760.0,580.0,1,228.0,1,1,1,3
16761.0,246.0,1,316.62,2,1,1,4
16762.0,0.0,3,1501.38,4,2,3,9
16763.0,158.0,3,947.75,2,2,3,7
16764.0,122.0,18,2758.25,2,4,4,10
16765.0,0.0,2,454.75,4,1,2,7
16766.0,38.0,2,1145.6,3,1,3,7
16767.0,66.0,16,7971.8,3,4,4,11
16768.0,435.0,14,1647.07,1,4,3,8
16769.0,0.0,4,1141.75,4,2,3,9
16770.0,667.0,11,1900.03,1,4,3,8
16771.0,99.0,10,3967.6,3,4,4,11
16772.0,366.0,5,2785.6,1,3,4,8
16773.0,912.0,3,421.24,1,2,2,5
16774.0,276.0,9,1587.85,2,4,3,9
16775.0,94.0,17,2975.29,3,4,4,11
16776.0,62.0,2,619.85,3,1,2,6
16777.0,609.0,6,1277.01,1,3,3,7
16778.0,69.0,2,245.94,3,1,1,5
16779.0,10.0,62,32981.61,3,4,4,11
16780.0,0.0,3,605.55,4,2,2,8
16781.0,455.0,3,901.05,1,2,3,6
16782.0,161.0,50,10348.960000000001,2,4,4,10
16783.0,0.0,1,391.95,4,1,2,7
16784.0,643.0,5,896.53,1,3,3,7
16785.0,0.0,1,533.78,4,1,2,7
16786.0,395.0,1,51.839999999999996,1,1,1,3
16787.0,367.0,4,1035.43,1,2,3,6
16788.0,125.0,5,1950.3,2,3,3,8
16789.0,333.0,1,80.8,2,1,1,4
16790.0,30.0,8,1520.1200000000001,3,3,3,9
16791.0,40.0,18,3946.12,3,4,4,11
16792.0,311.0,5,623.46,2,3,2,7
16793.0,0.0,1,243.84,4,1,1,6
16794.0,5.0,17,2069.71,3,4,3,10
16795.0,455.0,5,2465.19,1,3,4,8
16796.0,32.0,1,305.62,3,1,1,5
16797.0,394.0,9,1786.77,1,4,3,8
16798.0,526.0,4,837.56,1,2,2,5
16799.0,367.0,3,491.03000000000003,1,2,2,5
16800.0,0.0,1,1201.49,4,1,3,8
16801.0,38.0,5,867.83,3,3,3,9
16802.0,820.0,2,582.61,1,1,2,4
16803.0,215.0,1,332.3,2,1,2,5
16804.0,0.0,3,536.99,4,2,2,8
16805.0,401.0,5,1097.24,1,3,3,7
16806.0,281.0,4,801.49,2,2,2,6
16807.0,128.0,8,2064.88,2,3,3,8
16808.0,68.0,2,288.42,3,1,1,5
16809.0,92.0,10,1725.48,3,4,3,10
16810.0,0.0,4,786.14,4,2,2,8
16811.0,213.0,2,547.07,2,1,2,5
16812.0,0.0,5,2216.8,4,3,4,11
16813.0,246.0,10,1692.98,2,4,3,9
16814.0,7.0,37,12491.210000000001,3,4,4,11
16815.0,367.0,2,410.97,1,1,2,4
16816.0,0.0,4,417.06,4,2,2,8
16817.0,38.0,18,2594.55,3,4,4,11
16818.0,96.0,13,3317.97,3,4,4,11
16819.0,0.0,2,182.59,4,1,1,6
16820.0,216.0,1,497.61,2,1,2,5
16821.0,0.0,1,113.35,4,1,1,6
16822.0,851.0,3,144.84,1,2,1,4
16823.0,640.0,8,2253.14,1,3,4,8
16824.0,395.0,3,686.24,1,2,2,5
16825.0,158.0,5,1826.89,2,3,3,8
16826.0,0.0,1,341.7,4,1,2,7
16827.0,395.0,5,392.13,1,3,2,6
16828.0,155.0,2,128.5,2,1,1,4
16829.0,187.0,2,513.32,2,1,2,5
16830.0,334.0,5,1183.7,2,3,3,8
16831.0,0.0,1,91.8,4,1,1,6
16832.0,127.0,5,417.61,2,3,2,7
16833.0,101.0,6,2409.04,2,3,4,9
16834.0,649.0,2,898.96,1,1,3,5
16835.0,278.0,10,1471.51,2,4,3,9
16836.0,0.0,4,782.37,4,2,2,8
16837.0,31.0,12,3167.73,3,4,4,11
16838.0,161.0,6,1126.66,2,3,3,8
16839.0,2.0,51,20968.27,3,4,4,11
16840.0,649.0,3,126.71000000000001,1,2,1,4
16841.0,67.0,14,3841.16,3,4,4,11
16842.0,70.0,4,1260.44,3,2,3,8
16843.0,7.0,38,19528.78,3,4,4,11
16844.0,554.0,2,614.34,1,1,2,4
16845.0,0.0,1,253.88,4,1,1,6
16846.0,401.0,3,842.41,1,2,2,5
16847.0,0.0,2,614.89,4,1,2,7
16848.0,641.0,4,1411.62,1,2,3,6
16849.0,188.0,1,124.57,2,1,1,4
16850.0,71.0,1,332.41,3,1,2,6
16851.0,213.0,3,342.45,2,2,2,6
16852.0,0.0,2,144.91000000000003,4,1,1,6
16853.0,850.0,1,-67.5,1,1,1,3
16854.0,464.0,2,1408.96,1,1,3,5
16855.0,0.0,2,328.4,4,1,2,7
16856.0,0.0,3,358.49,4,2,2,8
16857.0,0.0,1,352.8,4,1,2,7
16858.0,374.0,16,4431.63,1,4,4,9
16859.0,522.0,10,1657.74,1,4,3,8
16860.0,0.0,4,1593.67,4,2,3,9
16861.0,31.0,6,902.37,3,3,3,9
16862.0,431.0,4,662.33,1,2,2,5
16863.0,61.0,5,977.07,3,3,3,9
16864.0,700.0,2,409.25,1,1,2,4
16865.0,640.0,1,130.95,1,1,1,3
16866.0,65.0,3,207.73999999999998,3,2,1,6
16867.0,0.0,1,76.74000000000001,4,1,1,6
16868.0,426.0,3,393.39,1,2,2,5
16869.0,0.0,5,805.62,4,3,2,9
16870.0,0.0,1,450.15999999999997,4,1,2,7
16871.0,32.0,7,2761.4900000000002,3,3,4,10
16872.0,127.0,6,1213.13,2,3,3,8
16873.0,92.0,17,14547.03,3,4,4,11
16874.0,0.0,1,217.74,4,1,1,6
16875.0,7.0,20,4053.2,3,4,4,11
16876.0,699.0,1,136.01,1,1,1,3
16877.0,65.0,6,853.72,3,3,3,9
16878.0,0.0,2,0.0,4,1,1,6
16879.0,0.0,2,-140.95999999999998,4,1,1,6
16880.0,65.0,8,1840.86,3,3,3,9
16881.0,245.0,1,432.0,2,1,2,5
16882.0,245.0,3,705.12,2,2,2,6
16883.0,219.0,20,2386.64,2,4,4,10
16884.0,303.0,4,1073.92,2,2,3,7
16885.0,0.0,4,710.74,4,2,2,8
16886.0,458.0,2,0.0,1,1,1,3
16887.0,244.0,3,660.72,2,2,2,6
16888.0,528.0,3,437.15,1,2,2,5
16889.0,68.0,6,2530.9,3,3,4,10
16890.0,554.0,3,285.41,1,2,1,4
16891.0,121.0,11,2056.82,2,4,3,9
16892.0,61.0,9,733.4,3,4,2,9
16893.0,486.0,2,401.77,1,1,2,4
16894.0,0.0,5,1282.36,4,3,3,10
16895.0,184.0,5,1121.42,2,3,3,8
16896.0,673.0,1,103.95,1,1,1,3
16897.0,0.0,3,213.03,4,2,1,7
16898.0,371.0,6,887.67,1,3,3,7
16899.0,32.0,8,1721.02,3,3,3,9
16900.0,62.0,5,187.6900000000001,3,3,1,7
16901.0,790.0,1,204.26,1,1,1,3
16902.0,0.0,1,1706.88,4,1,3,8
16903.0,61.0,4,1029.98,3,2,3,8
16904.0,61.0,21,5132.37,3,4,4,11
16905.0,243.0,20,5004.5,2,4,4,10
16906.0,188.0,7,1448.8,2,3,3,8
16907.0,60.0,9,1707.9,3,4,3,10
16908.0,0.0,2,153.59,4,1,1,6
16909.0,183.0,2,364.14,2,1,2,5
16910.0,93.0,8,1510.06,3,3,3,9
16911.0,0.0,3,251.35,4,2,1,7
16912.0,30.0,18,4433.6,3,4,4,11
16913.0,0.0,3,423.90999999999997,4,2,2,8
16914.0,275.0,1,208.46,2,1,1,4
16915.0,221.0,11,1543.18,2,4,3,9
16916.0,667.0,4,1123.4,1,2,3,6
16917.0,130.0,3,1848.88,2,2,3,7
16918.0,154.0,19,3138.06,2,4,4,10
16919.0,7.0,28,5053.81,3,4,4,11
16920.0,0.0,1,355.45,4,1,2,7
16921.0,92.0,3,446.67,3,2,2,7
16922.0,0.0,1,611.08,4,1,2,7
16923.0,65.0,41,12793.380000000001,3,4,4,11
16924.0,184.0,4,739.5,2,2,2,6
16925.0,0.0,1,125.65,4,1,1,6
16926.0,429.0,6,1410.4,1,3,3,7
16927.0,130.0,3,543.05,2,2,2,6
16928.0,33.0,33,3993.58,3,4,4,11
16929.0,157.0,7,1295.39,2,3,3,8
16930.0,304.0,3,380.55,2,2,2,6
16931.0,68.0,23,5233.62,3,4,4,11
16932.0,366.0,3,440.71,1,2,2,5
16933.0,121.0,16,3099.6,2,4,4,10
16934.0,522.0,7,2090.7400000000002,1,3,3,7
16935.0,0.0,3,535.1,4,2,2,8
16936.0,0.0,2,551.17,4,1,2,7
16937.0,0.0,1,202.1,4,1,1,6
16938.0,5.0,10,6209.93,3,4,4,11
16939.0,490.0,3,449.0,1,2,2,5
16940.0,851.0,11,6245.41,1,4,4,9
16941.0,525.0,1,33.0,1,1,1,3
16942.0,183.0,10,1894.11,2,4,3,9
16943.0,6.0,7,816.73,3,3,2,8
16944.0,463.0,1,101.36,1,1,1,3
16945.0,1.0,35,8530.66,3,4,4,11
16946.0,434.0,6,1199.54,1,3,3,7
16947.0,464.0,10,896.73,1,4,3,8
16948.0,432.0,7,868.77,1,3,3,7
16949.0,158.0,7,1161.27,2,3,3,8
16950.0,156.0,12,3725.19,2,4,4,10
16951.0,125.0,4,1262.75,2,2,3,7
16952.0,520.0,5,798.78,1,3,2,6
16953.0,91.0,1,20.8,3,1,1,5
16954.0,62.0,21,6037.33,3,4,4,11
16955.0,127.0,9,1261.16,2,4,3,9
16956.0,0.0,2,292.34,4,1,1,6
16957.0,283.0,2,416.64,2,1,2,5
16958.0,0.0,1,809.44,4,1,2,7
16959.0,0.0,1,117.35000000000001,4,1,1,6
16960.0,62.0,9,2021.98,3,4,3,10
16961.0,583.0,6,773.01,1,3,2,6
16962.0,0.0,1,251.04,4,1,1,6
16963.0,219.0,1,110.55000000000001,2,1,1,4
16964.0,912.0,2,207.85,1,1,1,3
16965.0,0.0,1,201.19,4,1,1,6
16966.0,333.0,10,2148.47,2,4,3,9
16967.0,280.0,1,319.02,2,1,1,4
16968.0,213.0,2,439.43,2,1,2,5
16969.0,339.0,3,650.41,2,2,2,6
16970.0,0.0,1,71.4,4,1,1,6
16971.0,152.0,2,232.20999999999998,2,1,1,4
16972.0,458.0,2,786.25,1,1,2,4
16973.0,0.0,1,127.0,4,1,1,6
16974.0,583.0,2,365.5,1,1,2,4
16975.0,365.0,5,902.4200000000001,2,3,3,8
16976.0,0.0,1,251.51999999999998,4,1,1,6
16977.0,456.0,4,496.0,1,2,2,5
16978.0,404.0,3,768.88,1,2,2,5
16979.0,61.0,12,2787.09,3,4,4,11
16980.0,519.0,3,1473.3300000000002,1,2,3,6
16981.0,0.0,1,-4620.86,4,1,1,6
16982.0,62.0,1,384.06,3,1,2,6
16983.0,5.0,12,3699.17,3,4,4,11
16984.0,2.0,19,10599.42,3,4,4,11
16985.0,2.0,26,10545.76,3,4,4,11
16986.0,61.0,11,4888.75,3,4,4,11
16987.0,181.0,12,2524.0,2,4,4,10
16988.0,243.0,2,382.67,2,1,2,5
16989.0,4.0,6,1133.25,3,3,3,9
16990.0,220.0,2,344.0,2,1,2,5
16991.0,0.0,1,1041.21,4,1,3,8
16992.0,275.0,15,5460.1,2,4,4,10
16993.0,371.0,3,1688.15,1,2,3,6
16994.0,0.0,1,-779.32,4,1,1,6
16995.0,667.0,1,-2.5,1,1,1,3
16996.0,64.0,13,2044.16,3,4,3,10
16997.0,284.0,3,702.0,2,2,2,6
16998.0,131.0,7,394.02000000000004,2,3,2,7
16999.0,0.0,2,484.82,4,1,2,7
17000.0,487.0,2,406.3,1,1,2,4
17001.0,90.0,19,6640.8,3,4,4,11
17002.0,128.0,8,2565.6,2,3,4,9
17003.0,366.0,4,830.16,1,2,2,5
17004.0,124.0,4,2425.16,2,2,4,8
17005.0,0.0,3,732.41,4,2,2,8
17006.0,121.0,8,1636.32,2,3,3,8
17007.0,97.0,8,1107.6,3,3,3,9
17008.0,549.0,1,81.36,1,1,1,3
17009.0,553.0,1,242.06,1,1,1,3
17010.0,0.0,2,185.46,4,1,1,6
17011.0,91.0,4,536.7,3,2,2,7
17012.0,0.0,1,384.16,4,1,2,7
17013.0,0.0,2,-3224.76,4,1,1,6
17014.0,153.0,4,565.58,2,2,2,6
17015.0,30.0,3,1842.56,3,2,3,8
17016.0,371.0,1,552.4,1,1,2,4
17017.0,1.0,41,8087.41,3,4,4,11
17018.0,401.0,6,2287.7,1,3,4,8
17019.0,547.0,13,3951.5,1,4,4,9
17020.0,648.0,2,935.62,1,1,3,5
17021.0,367.0,6,1182.22,1,3,3,7
17022.0,122.0,2,260.0,2,1,1,4
17023.0,405.0,3,800.18,1,2,2,5
17024.0,218.0,3,95.85,2,2,1,5
17025.0,62.0,5,1510.6399999999999,3,3,3,9
17026.0,158.0,3,208.98,2,2,1,5
17027.0,342.0,10,1285.41,2,4,3,9
17028.0,524.0,3,1593.83,1,2,3,6
17029.0,434.0,7,2137.3,1,3,3,7
17030.0,154.0,1,146.87,2,1,1,4
17031.0,126.0,6,2773.85,2,3,4,9
17032.0,431.0,13,2150.06,1,4,3,8
17033.0,97.0,4,1332.79,3,2,3,8
17034.0,0.0,7,1239.32,4,3,3,10
17035.0,39.0,5,568.39,3,3,2,8
17036.0,0.0,1,176.9,4,1,1,6
17037.0,0.0,2,1253.22,4,1,3,8
17038.0,91.0,2,743.17,3,1,2,6
17039.0,0.0,1,1954.99,4,1,3,8
17040.0,523.0,2,463.25,1,1,2,4
17041.0,518.0,7,1670.48,1,3,3,7
17042.0,64.0,5,1044.3799999999999,3,3,3,9
17043.0,153.0,8,2616.55,2,3,4,9
17044.0,333.0,16,11867.6,2,4,4,10
17045.0,187.0,5,827.6800000000001,2,3,2,7
17046.0,218.0,5,1906.07,2,3,3,8
17047.0,494.0,6,2289.23,1,3,4,8
17048.0,10.0,11,1991.45,3,4,3,10
17049.0,97.0,25,9593.78,3,4,4,11
17050.0,191.0,12,4391.66,2,4,4,10
17051.0,674.0,4,714.39,1,2,2,5
17052.0,30.0,1,413.75,3,1,2,6
17053.0,278.0,2,496.38,2,1,2,5
17054.0,30.0,6,1353.83,3,3,3,9
17055.0,0.0,1,239.55,4,1,1,6
17056.0,1063.0,1,128.60000000000002,1,1,1,3
17057.0,0.0,1,294.74,4,1,1,6
17058.0,0.0,3,1179.89,4,2,3,9
17059.0,61.0,10,5584.83,3,4,4,11
17060.0,0.0,1,234.24,4,1,1,6
17061.0,220.0,12,5116.13,2,4,4,10
17062.0,455.0,7,1204.32,1,3,3,7
17063.0,248.0,23,3576.88,2,4,4,10
17064.0,1.0,3,859.35,3,2,3,8
17065.0,373.0,3,82.35,1,2,1,4
17066.0,0.0,1,228.34,4,1,1,6
17067.0,851.0,3,454.54,1,2,2,5
17068.0,184.0,49,9126.43,2,4,4,10
17069.0,4.0,21,5718.4,3,4,4,11
17070.0,0.0,2,445.32,4,1,2,7
17071.0,2.0,20,3738.45,3,4,4,11
17072.0,0.0,1,282.05,4,1,1,6
17073.0,0.0,4,1446.09,4,2,3,9
17074.0,0.0,1,203.05,4,1,1,6
17075.0,549.0,11,2221.38,1,4,4,9
17076.0,38.0,6,1242.75,3,3,3,9
17077.0,432.0,1,306.0,1,1,1,3
17078.0,274.0,2,378.2,2,1,2,5
17079.0,0.0,1,118.80000000000001,4,1,1,6
17080.0,583.0,8,955.41,1,3,3,7
17081.0,456.0,6,964.39,1,3,3,7
17082.0,183.0,6,4732.03,2,3,4,9
17083.0,100.0,11,4035.08,3,4,4,11
17084.0,244.0,4,5199.72,2,2,4,8
17085.0,125.0,32,7757.41,2,4,4,10
17086.0,91.0,6,2050.08,3,3,3,9
17087.0,1032.0,1,221.53,1,1,1,3
17088.0,30.0,4,1991.01,3,2,3,8
17089.0,0.0,1,128.45,4,1,1,6
17090.0,2.0,15,3055.94,3,4,4,11
17091.0,122.0,23,7777.5,2,4,4,10
17092.0,161.0,14,5563.31,2,4,4,10
17093.0,0.0,1,235.88,4,1,1,6
17094.0,366.0,3,370.40000000000003,1,2,2,5
17095.0,10.0,12,2312.59,3,4,4,11
17096.0,1.0,17,3690.83,3,4,4,11
17097.0,152.0,10,1323.95,2,4,3,9
17098.0,0.0,3,591.0699999999999,4,2,2,8
17099.0,0.0,1,582.17,4,1,2,7
17100.0,0.0,2,971.74,4,1,3,8
17101.0,61.0,7,2507.05,3,3,4,10
17102.0,0.0,1,25.5,4,1,1,6
17103.0,0.0,1,424.3,4,1,2,7
17104.0,366.0,1,474.03,1,1,2,4
17105.0,192.0,2,665.78,2,1,2,5
17106.0,0.0,1,491.23,4,1,2,7
17107.0,153.0,13,15616.82,2,4,4,10
17108.0,0.0,1,174.95,4,1,1,6
17109.0,61.0,10,1280.1,3,4,3,10
17110.0,494.0,3,510.7,1,2,2,5
17111.0,427.0,2,476.58,1,1,2,4
17112.0,0.0,1,205.17,4,1,1,6
17113.0,402.0,8,2109.16,1,3,3,7
17114.0,68.0,10,747.22,3,4,2,9
17115.0,66.0,13,2616.29,3,4,4,11
17116.0,707.0,1,389.78,1,1,2,4
17117.0,0.0,1,116.19999999999999,4,1,1,6
17118.0,0.0,1,157.02,4,1,1,6
17119.0,31.0,3,593.61,3,2,2,7
17120.0,0.0,1,307.46,4,1,1,6
17121.0,668.0,1,314.74,1,1,1,3
17122.0,3.0,4,570.5,3,2,2,7
17123.0,338.0,3,977.17,2,2,3,7
17124.0,158.0,1,298.89,2,1,1,4
17125.0,0.0,1,259.35,4,1,1,6
17126.0,65.0,11,2057.54,3,4,3,10
17127.0,519.0,5,1155.0300000000002,1,3,3,7
17128.0,101.0,1,157.09,2,1,1,4
17129.0,522.0,1,31.85,1,1,1,3
17130.0,0.0,1,-18.38,4,1,1,6
17131.0,183.0,5,2463.17,2,3,4,9
17132.0,490.0,2,1272.8,1,1,3,5
17133.0,160.0,13,12972.09,2,4,4,10
17134.0,0.0,3,637.1,4,2,2,8
17135.0,303.0,11,1943.24,2,4,3,9
17136.0,0.0,1,231.68,4,1,1,6
17137.0,459.0,6,1133.63,1,3,3,7
17138.0,99.0,7,4417.27,3,3,4,10
17139.0,2.0,29,19491.61,3,4,4,11
17140.0,190.0,1,465.32,2,1,2,5
17141.0,0.0,4,754.33,4,2,2,8
17142.0,0.0,4,1283.75,4,2,3,9
17143.0,369.0,2,924.11,1,1,3,5
17144.0,120.0,2,984.57,2,1,3,6
17145.0,552.0,7,3014.64,1,3,4,8
17146.0,400.0,16,5795.99,1,4,4,9
17147.0,343.0,16,3069.15,2,4,4,10
17148.0,0.0,1,124.88,4,1,1,6
17149.0,0.0,1,143.10000000000002,4,1,1,6
17150.0,641.0,6,1375.65,1,3,3,7
17151.0,973.0,1,231.90000000000003,1,1,1,3
17152.0,427.0,5,1830.5,1,3,3,7
17153.0,0.0,1,213.78,4,1,1,6
17154.0,0.0,1,329.34,4,1,2,7
17155.0,851.0,7,892.46,1,3,3,7
17156.0,368.0,2,572.07,1,1,2,4
17157.0,302.0,20,5139.45,2,4,4,10
17158.0,153.0,6,1962.3,2,3,3,8
17159.0,183.0,6,2095.44,2,3,3,8
17160.0,7.0,18,10201.36,3,4,4,11
17161.0,0.0,1,856.01,4,1,3,8
17162.0,30.0,11,1707.21,3,4,3,10
17163.0,677.0,4,699.78,1,2,2,5
17164.0,34.0,8,2466.4,3,3,4,10
17165.0,375.0,8,1783.63,1,3,3,7
17166.0,334.0,3,189.49,2,2,1,5
17167.0,0.0,3,867.11,4,2,3,9
17168.0,0.0,1,400.2,4,1,2,7
17169.0,96.0,6,1129.8799999999999,3,3,3,9
17170.0,667.0,3,118.98,1,2,1,4
17171.0,0.0,2,384.59,4,1,2,7
17172.0,488.0,6,910.99,1,3,3,7
17173.0,1.0,9,3755.65,3,4,4,11
17174.0,189.0,1,59.9,2,1,1,4
17175.0,5.0,5,1430.94,3,3,3,9
17176.0,703.0,3,902.3199999999999,1,2,3,6
17177.0,0.0,1,119.5,4,1,1,6
17178.0,851.0,1,436.71,1,1,2,4
17179.0,0.0,6,1507.26,4,3,3,10
17180.0,7.0,14,2236.33,3,4,4,11
17181.0,698.0,3,465.37,1,2,2,5
17182.0,0.0,2,321.3,4,1,1,6
17183.0,122.0,8,3286.9100000000003,2,3,4,9
17184.0,820.0,2,198.41000000000003,1,1,1,3
17185.0,0.0,3,229.46,4,2,1,7
17186.0,62.0,2,144.0,3,1,1,5
17187.0,703.0,2,467.71,1,1,2,4
17188.0,61.0,17,4361.83,3,4,4,11
17189.0,1032.0,5,957.63,1,3,3,7
17190.0,1.0,8,1548.04,3,3,3,9
17191.0,30.0,16,4810.55,3,4,4,11
17192.0,0.0,1,77.83,4,1,1,6
17193.0,1.0,12,2254.6,3,4,4,11
17194.0,38.0,3,812.5,3,2,2,7
17195.0,0.0,1,562.98,4,1,2,7
17196.0,488.0,1,352.9,1,1,2,4
17197.0,61.0,1,1013.01,3,1,3,7
17198.0,455.0,3,1213.88,1,2,3,6
17199.0,554.0,1,145.12,1,1,1,3
17200.0,0.0,4,356.71,4,2,2,8
17201.0,435.0,5,1226.44,1,3,3,7
17202.0,0.0,1,160.65,4,1,1,6
17203.0,62.0,10,5575.88,3,4,4,11
17204.0,7.0,15,5263.69,3,4,4,11
17205.0,0.0,3,999.35,4,2,3,9
17206.0,0.0,1,204.24,4,1,1,6
17207.0,0.0,1,303.21999999999997,4,1,1,6
17208.0,456.0,1,115.35,1,1,1,3
17209.0,759.0,3,611.6,1,2,2,5
17210.0,365.0,1,253.37,2,1,1,4
17211.0,5.0,15,4002.1,3,4,4,11
17212.0,429.0,3,794.41,1,2,2,5
17213.0,39.0,20,5078.93,3,4,4,11
17214.0,62.0,7,984.12,3,3,3,9
17215.0,701.0,1,186.15,1,1,1,3
17216.0,645.0,1,65.05,1,1,1,3
17217.0,0.0,2,218.0,4,1,1,6
17218.0,32.0,18,4192.68,3,4,4,11
17219.0,122.0,2,259.13,2,1,1,4
17220.0,187.0,21,4481.75,2,4,4,10
17221.0,274.0,5,978.52,2,3,3,8
17222.0,215.0,6,1605.01,2,3,3,8
17223.0,312.0,3,873.53,2,2,3,7
17224.0,0.0,1,100.86,4,1,1,6
17225.0,524.0,1,131.15,1,1,1,3
17226.0,253.0,3,900.12,2,2,3,7
17227.0,62.0,12,2022.03,3,4,3,10
17228.0,154.0,13,3177.24,2,4,4,10
17229.0,246.0,2,318.76,2,1,1,4
17230.0,70.0,23,9695.91,3,4,4,11
17231.0,128.0,35,7091.07,2,4,4,10
17232.0,152.0,2,421.52,2,1,2,5
17233.0,244.0,3,560.86,2,2,2,6
17234.0,66.0,1,149.89000000000001,3,1,1,5
17235.0,612.0,8,1904.8799999999999,1,3,3,7
17236.0,37.0,12,1929.26,3,4,3,10
17237.0,0.0,4,1002.08,4,2,3,9
17238.0,30.0,32,7783.1,3,4,4,11
17239.0,427.0,6,1174.15,1,3,3,7
17240.0,0.0,1,130.6,4,1,1,6
17241.0,369.0,12,2744.14,1,4,4,9
17242.0,5.0,5,2889.28,3,3,4,10
17243.0,30.0,80,20709.21,3,4,4,11
17244.0,912.0,5,1826.04,1,3,3,7
17245.0,0.0,2,371.63,4,1,2,7
17246.0,400.0,2,38.92,1,1,1,3
17247.0,0.0,1,282.19,4,1,1,6
17248.0,33.0,2,546.16,3,1,2,6
17249.0,519.0,1,68.03,1,1,1,3
17250.0,182.0,2,384.52,2,1,2,5
17251.0,364.0,4,803.73,2,2,2,6
17252.0,188.0,2,353.86,2,1,2,5
17253.0,0.0,1,178.26,4,1,1,6
17254.0,213.0,3,470.73,2,2,2,6
17255.0,0.0,4,799.13,4,2,2,8
17256.0,0.0,5,498.93,4,3,2,9
17257.0,0.0,2,192.73,4,1,1,6
17258.0,374.0,2,417.3,1,1,2,4
17259.0,547.0,6,1889.34,1,3,3,7
17260.0,0.0,1,120.95,4,1,1,6
17261.0,0.0,1,230.44,4,1,1,6
17262.0,486.0,11,2757.62,1,4,4,9
17263.0,0.0,1,63.440000000000005,4,1,1,6
17264.0,396.0,1,279.59,1,1,1,3
17265.0,5.0,2,562.9,3,1,2,6
17266.0,152.0,5,517.73,2,3,2,7
17267.0,246.0,2,317.62,2,1,1,4
17268.0,4.0,11,1733.8899999999999,3,4,3,10
17269.0,0.0,1,537.46,4,1,2,7
17270.0,882.0,2,604.4,1,1,2,4
17271.0,1004.0,1,210.39,1,1,1,3
17272.0,0.0,5,2144.53,4,3,3,10
17273.0,396.0,1,141.12,1,1,1,3
17274.0,244.0,2,577.38,2,1,2,5
17275.0,0.0,1,114.52,4,1,1,6
17276.0,579.0,2,451.34000000000003,1,1,2,4
17277.0,0.0,2,1065.3500000000001,4,1,3,8
17278.0,7.0,2,271.24,3,1,1,5
17279.0,0.0,1,187.82999999999998,4,1,1,6
17280.0,0.0,1,118.85999999999999,4,1,1,6
17281.0,555.0,6,797.8499999999999,1,3,2,6
17282.0,337.0,5,2339.66,2,3,4,9
17283.0,0.0,1,188.46,4,1,1,6
17284.0,33.0,11,2328.22,3,4,4,11
17285.0,0.0,2,428.34,4,1,2,7
17286.0,609.0,3,395.48,1,2,2,5
17287.0,341.0,23,4095.71,2,4,4,10
17288.0,341.0,11,2499.98,2,4,4,10
17289.0,5.0,11,2069.89,3,4,3,10
17290.0,182.0,8,1501.44,2,3,3,8
17291.0,253.0,1,550.8000000000001,2,1,2,5
17292.0,462.0,2,271.75,1,1,1,3
17293.0,1.0,17,3774.23,3,4,4,11
17294.0,496.0,2,467.78999999999996,1,1,2,4
17295.0,30.0,3,556.95,3,2,2,7
17296.0,820.0,1,338.13,1,1,2,4
17297.0,0.0,1,131.78,4,1,1,6
17298.0,156.0,6,952.52,2,3,3,8
17299.0,32.0,6,1016.08,3,3,3,9
17300.0,0.0,2,393.64,4,1,2,7
17301.0,0.0,2,330.43,4,1,2,7
17302.0,94.0,6,1119.93,3,3,3,9
17303.0,0.0,1,250.04,4,1,1,6
17304.0,0.0,1,111.5,4,1,1,6
17305.0,707.0,1,2135.46,1,1,3,5
17306.0,130.0,23,9751.77,2,4,4,10
17307.0,396.0,15,3225.67,1,4,4,9
17308.0,395.0,2,4511.76,1,1,4,6
17309.0,216.0,3,330.59000000000003,2,2,2,6
17310.0,0.0,2,1025.1,4,1,3,8
17311.0,365.0,7,3490.66,2,3,4,9
17312.0,156.0,3,644.3,2,2,2,6
17313.0,122.0,2,2288.13,2,1,4,7
17314.0,1.0,22,4514.7,3,4,4,11
17315.0,6.0,49,9558.55,3,4,4,11
17316.0,0.0,1,124.45,4,1,1,6
17317.0,32.0,5,2524.02,3,3,4,10
17318.0,0.0,1,164.28,4,1,1,6
17319.0,496.0,1,29.1,1,1,1,3
17320.0,547.0,6,2895.77,1,3,4,8
17321.0,276.0,6,1741.18,2,3,3,8
17322.0,1004.0,7,900.64,1,3,3,7
17323.0,92.0,14,1553.51,3,4,3,10
17324.0,10.0,13,2148.87,3,4,3,10
17325.0,252.0,3,609.5699999999999,2,2,2,6
17326.0,0.0,2,321.95,4,1,1,6
17327.0,0.0,2,152.35,4,1,1,6
17328.0,618.0,1,104.7,1,1,1,3
17329.0,851.0,5,1004.4300000000001,1,3,3,7
17330.0,276.0,4,423.8,2,2,2,6
17331.0,125.0,1,175.2,2,1,1,4
17332.0,462.0,5,838.27,1,3,2,6
17333.0,0.0,1,494.25,4,1,2,7
17334.0,39.0,4,634.73,3,2,2,7
17335.0,0.0,2,508.0,4,1,2,7
17336.0,0.0,1,81.12,4,1,1,6
17337.0,5.0,7,1944.32,3,3,3,9
17338.0,10.0,20,12036.57,3,4,4,11
17339.0,185.0,4,303.36,2,2,1,5
17340.0,33.0,30,21411.64,3,4,4,11
17341.0,187.0,5,1889.83,2,3,3,8
17342.0,496.0,7,1155.8400000000001,1,3,3,7
17343.0,1003.0,6,1259.94,1,3,3,7
17344.0,759.0,3,454.61,1,2,2,5
17345.0,155.0,12,1484.3799999999999,2,4,3,9
17346.0,1.0,27,5258.02,3,4,4,11
17347.0,0.0,1,228.96,4,1,1,6
17348.0,30.0,9,2476.41,3,4,4,11
17349.0,0.0,5,852.25,4,3,3,10
17350.0,333.0,8,1876.161,2,3,3,8
17351.0,38.0,12,1988.23,3,4,3,10
17352.0,375.0,1,36.25,1,1,1,3
17353.0,126.0,7,3155.55,2,3,4,9
17354.0,519.0,4,3143.46,1,2,4,7
17355.0,0.0,1,285.11,4,1,1,6
17356.0,343.0,5,946.47,2,3,3,8
17357.0,0.0,2,388.14,4,1,2,7
17358.0,100.0,5,866.05,3,3,3,9
17359.0,707.0,2,284.46,1,1,1,3
17360.0,127.0,7,1201.43,2,3,3,8
17361.0,188.0,5,880.64,2,3,3,8
17362.0,284.0,8,1010.54,2,3,3,8
17363.0,456.0,3,940.86,1,2,3,6
17364.0,10.0,31,11684.55,3,4,4,11
17365.0,40.0,16,8205.83,3,4,4,11
17366.0,365.0,3,1094.59,2,2,3,7
17367.0,0.0,1,168.4,4,1,1,6
17368.0,153.0,16,2213.24,2,4,4,10
17369.0,428.0,1,979.1999999999999,1,1,3,5
17370.0,124.0,4,446.18,2,2,2,6
17371.0,851.0,6,662.55,1,3,2,6
17372.0,62.0,31,4325.43,3,4,4,11
17373.0,0.0,7,1167.5,4,3,3,10
17374.0,220.0,4,711.21,2,2,2,6
17375.0,307.0,5,632.95,2,3,2,7
17376.0,343.0,4,453.64,2,2,2,6
17377.0,32.0,91,17851.41,3,4,4,11
17378.0,0.0,2,0.0,4,1,1,6
17379.0,0.0,1,404.66,4,1,2,7
17380.0,583.0,4,643.75,1,2,2,5
17381.0,3.0,39,39999.19,3,4,4,11
17382.0,215.0,8,902.28,2,3,3,8
17383.0,212.0,2,309.99,2,1,1,4
17384.0,250.0,3,507.55,2,2,2,6
17385.0,0.0,1,261.11,4,1,1,6
17386.0,302.0,7,2812.77,2,3,4,9
17387.0,183.0,2,784.11,2,1,2,5
17388.0,6.0,11,2691.57,3,4,4,11
17389.0,10.0,77,54587.03,3,4,4,11
17390.0,0.0,1,149.3,4,1,1,6
17391.0,0.0,2,508.8,4,1,2,7
17392.0,192.0,3,626.56,2,2,2,6
17393.0,490.0,2,381.15,1,1,2,4
17394.0,250.0,1,203.86999999999998,2,1,1,4
17395.0,0.0,1,97.5,4,1,1,6
17396.0,276.0,16,8529.6,2,4,4,10
17397.0,0.0,3,1233.18,4,2,3,9
17398.0,0.0,3,653.38,4,2,2,8
17399.0,0.0,1,-25111.09,4,1,1,6
17400.0,217.0,8,4677.05,2,3,4,9
17401.0,0.0,1,114.85,4,1,1,6
17402.0,91.0,26,5047.08,3,4,4,11
17403.0,275.0,2,400.57,2,1,2,5
17404.0,6.0,28,46006.82,3,4,4,11
17405.0,4.0,5,967.22,3,3,3,9
17406.0,71.0,18,4592.1,3,4,4,11
17407.0,0.0,1,552.9,4,1,2,7
17408.0,0.0,4,164.89000000000001,4,2,1,7
17409.0,127.0,10,7793.51,2,4,4,10
17410.0,1.0,5,1214.72,3,3,3,9
17411.0,455.0,9,1286.53,1,4,3,8
17412.0,31.0,19,4384.98,3,4,4,11
17413.0,0.0,2,560.14,4,1,2,7
17414.0,127.0,6,2249.52,2,3,4,9
17415.0,0.0,1,507.84,4,1,2,7
17416.0,61.0,25,17221.47,3,4,4,11
17417.0,461.0,1,164.18,1,1,1,3
17418.0,0.0,3,670.0600000000001,4,2,2,8
17419.0,62.0,20,6474.92,3,4,4,11
17420.0,640.0,8,1074.53,1,3,3,7
17421.0,549.0,3,1059.41,1,2,3,6
17422.0,5.0,20,3341.65,3,4,4,11
17423.0,189.0,5,1084.17,2,3,3,8
17424.0,519.0,1,-176.96,1,1,1,3
17425.0,62.0,2,759.17,3,1,2,6
17426.0,93.0,17,7606.37,3,4,4,11
17427.0,0.0,1,100.8,4,1,1,6
17428.0,7.0,51,31238.06,3,4,4,11
17429.0,33.0,7,1342.16,3,3,3,9
17430.0,153.0,4,735.17,2,2,2,6
17431.0,0.0,1,403.3,4,1,2,7
17432.0,302.0,9,1751.39,2,4,3,9
17433.0,2.0,2,569.96,3,1,2,6
17434.0,152.0,9,2333.42,2,4,4,10
17435.0,0.0,1,331.35,4,1,2,7
17436.0,121.0,7,521.31,2,3,2,7
17437.0,0.0,1,373.17,4,1,2,7
17438.0,190.0,6,1412.6200000000001,2,3,3,8
17439.0,0.0,1,325.74,4,1,2,7
17440.0,187.0,6,314.26,2,3,1,6
17441.0,882.0,1,293.35,1,1,1,3
17442.0,61.0,23,4500.7,3,4,4,11
17443.0,250.0,1,534.24,2,1,2,5
17444.0,34.0,3,2940.04,3,2,4,9
17445.0,0.0,1,-506.51,4,1,1,6
17446.0,312.0,2,120.9,2,1,1,4
17447.0,0.0,2,541.53,4,1,2,7
17448.0,373.0,54,10192.73,1,4,4,9
17449.0,1.0,14,4935.15,3,4,4,11
17450.0,4.0,61,233579.38999999998,3,4,4,11
17451.0,121.0,10,1648.95,2,4,3,9
17452.0,0.0,1,-227.28,4,1,1,6
17453.0,184.0,2,486.71999999999997,2,1,2,5
17454.0,401.0,11,1532.64,1,4,3,8
17455.0,0.0,1,131.7,4,1,1,6
17456.0,455.0,2,1225.42,1,1,3,5
17457.0,217.0,18,5799.01,2,4,4,10
17458.0,0.0,2,529.58,4,1,2,7
17459.0,62.0,2,657.3,3,1,2,6
17460.0,185.0,21,2007.4,2,4,3,9
17461.0,61.0,3,757.46,3,2,2,7
17462.0,62.0,3,662.94,3,2,2,7
17463.0,704.0,9,2537.91,1,4,4,9
17464.0,248.0,4,879.74,2,2,3,7
17465.0,427.0,9,2533.64,1,4,4,9
17466.0,0.0,2,763.28,4,1,2,7
17467.0,456.0,1,102.6,1,1,1,3
17468.0,0.0,3,194.8,4,2,1,7
17469.0,187.0,22,4958.34,2,4,4,10
17470.0,189.0,11,2804.87,2,4,4,10
17471.0,0.0,1,321.65000000000003,4,1,1,6
17472.0,339.0,4,935.1,2,2,3,7
17473.0,457.0,3,592.15,1,2,2,5
17474.0,0.0,1,1047.0,4,1,3,8
17475.0,0.0,1,194.37,4,1,1,6
17476.0,394.0,4,446.51,1,2,2,5
17477.0,526.0,5,1079.0,1,3,3,7
17478.0,0.0,2,1272.8,4,1,3,8
17479.0,0.0,1,389.26000000000005,4,1,2,7
17480.0,0.0,3,896.72,4,2,3,9
17481.0,155.0,5,1249.34,2,3,3,8
17482.0,432.0,2,778.19,1,1,2,4
17483.0,95.0,4,591.73,3,2,2,7
17484.0,371.0,2,209.57,1,1,1,3
17485.0,1063.0,1,-29.55,1,1,1,3
17486.0,0.0,1,396.87,4,1,2,7
17487.0,759.0,1,160.55,1,1,1,3
17488.0,495.0,1,336.5,1,1,2,4
17489.0,1.0,2,376.64,3,1,2,6
17490.0,90.0,13,2585.06,3,4,4,11
17491.0,121.0,18,5964.12,2,4,4,10
17492.0,221.0,3,1122.42,2,2,3,7
17493.0,0.0,1,100.91000000000001,4,1,1,6
17494.0,0.0,1,54.699999999999996,4,1,1,6
17495.0,302.0,4,759.07,2,2,2,6
17496.0,554.0,5,1385.89,1,3,3,7
17497.0,494.0,2,287.25,1,1,1,3
17498.0,0.0,1,272.22,4,1,1,6
17499.0,431.0,3,1296.84,1,2,3,6
17500.0,61.0,3,1138.0,3,2,3,8
17501.0,281.0,2,288.6,2,1,1,4
17502.0,61.0,4,689.1,3,2,2,7
17503.0,152.0,2,558.96,2,1,2,5
17504.0,67.0,19,9313.37,3,4,4,11
17505.0,338.0,5,2435.48,2,3,4,9
17506.0,0.0,2,294.29,4,1,1,6
17507.0,283.0,2,605.58,2,1,2,5
17508.0,252.0,9,4546.78,2,4,4,10
17509.0,62.0,11,6100.74,3,4,4,11
17510.0,0.0,2,514.56,4,1,2,7
17511.0,7.0,85,171885.98,3,4,4,11
17512.0,30.0,20,5432.27,3,4,4,11
17513.0,0.0,3,1158.8,4,2,3,9
17514.0,278.0,2,542.83,2,1,2,5
17515.0,122.0,9,1617.46,2,4,3,9
17516.0,3.0,6,957.55,3,3,3,9
17517.0,253.0,1,153.94,2,1,1,4
17518.0,427.0,2,329.42,1,1,2,4
17519.0,491.0,17,5102.8,1,4,4,9
17520.0,0.0,1,546.81,4,1,2,7
17521.0,61.0,6,1276.81,3,3,3,9
17522.0,96.0,5,1070.71,3,3,3,9
17523.0,0.0,4,652.74,4,2,2,8
17524.0,0.0,4,508.9,4,2,2,8
17525.0,518.0,3,1161.9,1,2,3,6
17526.0,120.0,16,3676.84,2,4,4,10
17527.0,62.0,6,888.86,3,3,3,9
17528.0,1.0,11,3540.1,3,4,4,11
17529.0,405.0,2,1240.25,1,1,3,5
17530.0,120.0,13,3140.56,2,4,4,10
17531.0,33.0,9,1191.22,3,4,3,10
17532.0,0.0,1,65.34,4,1,1,6
17533.0,700.0,1,34.8,1,1,1,3
17534.0,0.0,5,1668.83,4,3,3,10
17535.0,252.0,1,164.4,2,1,1,4
17536.0,0.0,3,364.83,4,2,2,8
17537.0,61.0,2,897.62,3,1,3,7
17538.0,0.0,1,98.42,4,1,1,6
17539.0,436.0,7,1047.07,1,3,3,7
17540.0,333.0,7,1582.1000000000001,2,3,3,8
17541.0,0.0,1,124.46,4,1,1,6
17542.0,495.0,3,341.7,1,2,2,5
17543.0,492.0,1,120.05,1,1,1,3
17544.0,0.0,3,960.69,4,2,3,9
17545.0,401.0,6,1448.54,1,3,3,7
17546.0,400.0,1,-648.05,1,1,1,3
17547.0,374.0,4,680.5500000000001,1,2,2,5
17548.0,189.0,6,345.0,2,3,2,7
17549.0,0.0,2,148.86,4,1,1,6
17550.0,68.0,10,2206.54,3,4,4,11
17551.0,0.0,1,306.84,4,1,1,6
17552.0,62.0,16,3039.2,3,4,4,11
17553.0,306.0,4,3757.6,2,2,4,8
17554.0,31.0,5,1952.45,3,3,3,9
17555.0,101.0,5,1057.74,2,3,3,8
17556.0,0.0,2,300.67,4,1,1,6
17557.0,882.0,4,575.46,1,2,2,5
17558.0,395.0,1,259.17,1,1,1,3
17559.0,0.0,1,167.62,4,1,1,6
17560.0,70.0,9,1895.8,3,4,3,10
17561.0,912.0,4,722.34,1,2,2,5
17562.0,64.0,8,1107.38,3,3,3,9
17563.0,432.0,5,309.28000000000003,1,3,1,5
17564.0,0.0,3,454.01,4,2,2,8
17565.0,674.0,1,131.83,1,1,1,3
17566.0,332.0,2,901.21,2,1,3,6
17567.0,69.0,11,5037.11,3,4,4,11
17568.0,0.0,1,382.79,4,1,2,7
17569.0,40.0,1,344.14,3,1,2,6
17570.0,0.0,2,0.0,4,1,1,6
17571.0,161.0,5,1703.75,2,3,3,8
17572.0,336.0,10,723.01,2,4,2,8
17573.0,61.0,4,362.9,3,2,2,7
17574.0,37.0,1,185.65,3,1,1,5
17575.0,435.0,1,171.7,1,1,1,3
17576.0,3.0,45,8885.66,3,4,4,11
17577.0,465.0,2,348.75,1,1,2,4
17578.0,219.0,10,1003.73,2,4,3,9
17579.0,33.0,5,744.58,3,3,2,8
17580.0,341.0,5,545.27,2,3,2,7
17581.0,67.0,53,18247.47,3,4,4,11
17582.0,0.0,6,1433.7,4,3,3,10
17583.0,0.0,1,135.95,4,1,1,6
17584.0,247.0,7,5294.42,2,3,4,9
17585.0,224.0,7,2093.3,2,3,3,8
17586.0,0.0,1,167.4,4,1,1,6
17587.0,0.0,1,181.66,4,1,1,6
17588.0,373.0,9,2901.65,1,4,4,9
17589.0,34.0,21,13904.82,3,4,4,11
17590.0,152.0,3,1479.22,2,2,3,7
17591.0,94.0,9,2765.7200000000003,3,4,4,11
17592.0,1063.0,2,0.0,1,1,1,3
17593.0,93.0,15,8044.0,3,4,4,11
17594.0,0.0,4,2497.88,4,2,4,10
17595.0,303.0,2,388.79,2,1,2,5
17596.0,154.0,14,4907.32,2,4,4,10
17597.0,67.0,7,3425.29,3,3,4,10
17598.0,0.0,1,409.98,4,1,2,7
17599.0,701.0,3,44.55,1,2,1,4
17600.0,0.0,1,161.67000000000002,4,1,1,6
17601.0,0.0,2,421.48,4,1,2,7
17602.0,64.0,18,7337.43,3,4,4,11
17603.0,587.0,11,120.01000000000002,1,4,1,6
17604.0,189.0,6,945.9300000000001,2,3,3,8
17605.0,0.0,1,160.75,4,1,1,6
17606.0,1032.0,1,87.30000000000001,1,1,1,3
17607.0,0.0,1,333.81,4,1,2,7
17608.0,183.0,4,498.53,2,2,2,6
17609.0,69.0,14,1758.99,3,4,3,10
17610.0,432.0,8,1427.84,1,3,3,7
17611.0,37.0,35,8205.38,3,4,4,11
17612.0,97.0,32,5156.14,3,4,4,11
17613.0,162.0,17,4509.37,2,4,4,10
17614.0,0.0,1,390.07,4,1,2,7
17615.0,337.0,7,725.7,2,3,2,7
17616.0,517.0,4,1060.8,1,2,3,6
17617.0,0.0,2,237.28,4,1,1,6
17618.0,221.0,13,4047.94,2,4,4,10
17619.0,0.0,1,218.52,4,1,1,6
17620.0,31.0,1,81.44,3,1,1,5
17621.0,339.0,8,3029.32,2,3,4,9
17622.0,0.0,3,1125.17,4,2,3,9
17623.0,153.0,7,2383.67,2,3,4,9
17624.0,219.0,4,1568.63,2,2,3,7
17625.0,0.0,8,6067.8,4,3,4,11
17626.0,0.0,1,254.0,4,1,1,6
17627.0,789.0,2,285.11,1,1,1,3
17628.0,0.0,1,75.75,4,1,1,6
17629.0,33.0,11,2425.52,3,4,4,11
17630.0,0.0,2,503.59999999999997,4,1,2,7
17631.0,121.0,7,998.49,2,3,3,8
17632.0,0.0,2,-12.7,4,1,1,6
17633.0,33.0,9,1974.89,3,4,3,10
17634.0,36.0,9,2361.9700000000003,3,4,4,11
17635.0,396.0,4,1256.83,1,2,3,6
17636.0,333.0,2,265.93,2,1,1,4
17637.0,122.0,2,547.0600000000001,2,1,2,5
17638.0,676.0,2,842.4,1,1,2,4
17639.0,130.0,6,615.17,2,3,2,7
17640.0,367.0,8,3107.59,1,3,4,8
17641.0,1063.0,1,-6.95,1,1,1,3
17642.0,3.0,5,1824.49,3,3,3,9
17643.0,698.0,2,541.25,1,1,2,4
17644.0,33.0,28,5864.54,3,4,4,11
17645.0,759.0,1,-9.9,1,1,1,3
17646.0,250.0,16,4094.1600000000003,2,4,4,10
17647.0,215.0,3,331.65999999999997,2,2,2,6
17648.0,62.0,6,2208.42,3,3,4,10
17649.0,0.0,5,1542.44,4,3,3,10
17650.0,0.0,1,166.08,4,1,1,6
17651.0,61.0,22,5632.59,3,4,4,11
17652.0,61.0,18,4737.13,3,4,4,11
17653.0,33.0,5,1175.88,3,3,3,9
17654.0,161.0,1,117.55,2,1,1,4
17655.0,131.0,10,3585.28,2,4,4,10
17656.0,2.0,5,1674.69,3,3,3,9
17657.0,580.0,1,126.0,1,1,1,3
17658.0,6.0,3,485.88,3,2,2,7
17659.0,31.0,17,3784.13,3,4,4,11
17660.0,1032.0,2,359.47,1,1,2,4
17661.0,495.0,1,-54.0,1,1,1,3
17662.0,0.0,2,412.92,4,1,2,7
17663.0,126.0,23,5081.04,2,4,4,10
17664.0,36.0,4,1166.23,3,2,3,8
17665.0,643.0,1,563.1,1,1,2,4
17666.0,182.0,5,2047.8,2,3,3,8
17667.0,6.0,12,3883.8,3,4,4,11
17668.0,121.0,2,347.75,2,1,2,5
17669.0,94.0,10,6142.35,3,4,4,11
17670.0,0.0,1,205.7,4,1,1,6
17671.0,5.0,7,2114.71,3,3,3,9
17672.0,161.0,9,5707.08,2,4,4,10
17673.0,121.0,15,4216.33,2,4,4,10
17674.0,547.0,2,851.7,1,1,3,5
17675.0,4.0,90,37605.840000000004,3,4,4,11
17676.0,1.0,13,2722.52,3,4,4,11
17677.0,30.0,91,35866.63,3,4,4,11
17678.0,0.0,3,579.81,4,2,2,8
17679.0,552.0,11,3166.56,1,4,4,9
17680.0,0.0,4,462.5,4,2,2,8
17681.0,759.0,6,529.6,1,3,2,6
17682.0,190.0,12,4441.78,2,4,4,10
17683.0,645.0,3,819.01,1,2,2,5
17684.0,0.0,1,239.41,4,1,1,6
17685.0,2.0,14,5928.17,3,4,4,11
17686.0,33.0,9,8296.81,3,4,4,11
17687.0,0.0,1,432.68,4,1,2,7
17688.0,395.0,2,286.5,1,1,1,3
17689.0,0.0,2,317.08,4,1,1,6
17690.0,91.0,21,7438.6,3,4,4,11
17691.0,400.0,5,769.85,1,3,2,6
17692.0,162.0,14,2962.4,2,4,4,10
17693.0,0.0,3,187.02,4,2,1,7
17694.0,0.0,3,1695.97,4,2,3,9
17695.0,426.0,6,1720.54,1,3,3,7
17696.0,2.0,48,7380.89,3,4,4,11
17697.0,0.0,1,338.95,4,1,2,7
17698.0,0.0,1,154.95,4,1,1,6
17699.0,0.0,2,442.0,4,1,2,7
17700.0,67.0,17,6630.87,3,4,4,11
17701.0,341.0,1,417.95,2,1,2,5
17702.0,91.0,9,2911.79,3,4,4,11
17703.0,244.0,4,1094.84,2,2,3,7
17704.0,0.0,2,885.19,4,1,3,8
17705.0,39.0,12,2041.5,3,4,3,10
17706.0,34.0,43,19543.9,3,4,4,11
17707.0,158.0,9,605.0500000000001,2,4,2,8
17708.0,219.0,4,887.9300000000001,2,2,3,7
17709.0,490.0,5,671.01,1,3,2,6
17710.0,366.0,1,293.5,1,1,1,3
17711.0,0.0,2,385.1,4,1,2,7
17712.0,0.0,1,522.91,4,1,2,7
17713.0,461.0,4,1198.09,1,2,3,6
17714.0,396.0,9,1376.58,1,4,3,8
17715.0,0.0,2,489.59999999999997,4,1,2,7
17716.0,61.0,27,15671.32,3,4,4,11
17717.0,0.0,1,376.92,4,1,2,7
17718.0,587.0,3,386.98,1,2,2,5
17719.0,2.0,18,5367.8,3,4,4,11
17720.0,432.0,12,2715.06,1,4,4,9
17721.0,0.0,1,307.21000000000004,4,1,1,6
17722.0,246.0,7,4386.96,2,3,4,9
17723.0,97.0,7,3378.4000000000005,3,3,4,10
17724.0,0.0,4,995.6500000000001,4,2,3,9
17725.0,221.0,14,3371.13,2,4,4,10
17726.0,456.0,8,1089.56,1,3,3,7
17727.0,0.0,2,1042.55,4,1,3,8
17728.0,182.0,8,3861.13,2,3,4,9
17729.0,0.0,1,438.65000000000003,4,1,2,7
17730.0,30.0,23,7757.35,3,4,4,11
17731.0,96.0,7,1347.08,3,3,3,9
17732.0,459.0,10,2448.14,1,4,4,9
17733.0,334.0,2,692.19,2,1,2,5
17734.0,402.0,6,1442.32,1,3,3,7
17735.0,126.0,29,17162.58,2,4,4,10
17736.0,122.0,4,337.49,2,2,2,6
17737.0,1.0,2,168.24,3,1,1,5
17738.0,311.0,15,4145.36,2,4,4,10
17739.0,71.0,20,7718.14,3,4,4,11
17740.0,405.0,6,426.9,1,3,2,6
17741.0,0.0,2,101.1,4,1,1,6
17742.0,40.0,11,2098.48,3,4,3,10
17743.0,0.0,2,208.85,4,1,1,6
17744.0,182.0,8,2617.82,2,3,4,9
17745.0,673.0,2,600.34,1,1,2,4
17746.0,494.0,7,873.4300000000001,1,3,3,7
17747.0,0.0,2,64.65,4,1,1,6
17748.0,0.0,1,358.15,4,1,2,7
17749.0,400.0,3,1026.18,1,2,3,6
17750.0,243.0,9,1797.57,2,4,3,9
17751.0,0.0,1,157.85999999999999,4,1,1,6
17752.0,0.0,1,80.64,4,1,1,6
17753.0,558.0,5,388.06,1,3,2,6
17754.0,90.0,16,4509.39,3,4,4,11
17755.0,396.0,1,-72.23,1,1,1,3
17756.0,426.0,3,733.7,1,2,2,5
17757.0,65.0,60,9342.84,3,4,4,11
17758.0,65.0,12,5012.53,3,4,4,11
17759.0,395.0,5,1276.91,1,3,3,7
17760.0,698.0,7,911.68,1,3,3,7
17761.0,153.0,1,712.78,2,1,2,5
17762.0,457.0,1,129.75,1,1,1,3
17763.0,617.0,5,51.15,1,3,1,5
17764.0,6.0,5,1623.64,3,3,3,9
17765.0,248.0,4,530.8,2,2,2,6
17766.0,0.0,2,299.61,4,1,1,6
17767.0,0.0,2,413.05,4,1,2,7
17768.0,183.0,8,3504.56,2,3,4,9
17769.0,31.0,21,6994.66,3,4,4,11
17770.0,36.0,5,1143.27,3,3,3,9
17771.0,0.0,4,387.41,4,2,2,8
17772.0,365.0,3,384.77,2,2,2,6
17773.0,0.0,2,585.27,4,1,2,7
17774.0,162.0,13,2945.7,2,4,4,10
17775.0,0.0,1,56.4,4,1,1,6
17776.0,0.0,3,331.81,4,2,2,8
17777.0,0.0,3,665.86,4,2,2,8
17778.0,0.0,1,197.70000000000002,4,1,1,6
17779.0,0.0,5,642.17,4,3,2,9
17780.0,435.0,3,352.91,1,2,2,5
17781.0,279.0,2,188.02,2,1,1,4
17782.0,0.0,2,679.02,4,1,2,7
17783.0,190.0,3,379.91,2,2,2,6
17784.0,523.0,1,112.86,1,1,1,3
17785.0,0.0,3,403.38,4,2,2,8
17786.0,0.0,2,278.74,4,1,1,6
17787.0,65.0,4,2601.4700000000003,3,2,4,9
17788.0,306.0,2,1117.9,2,1,3,6
17789.0,283.0,2,397.15,2,1,2,5
17790.0,4.0,20,2783.61,3,4,4,11
17791.0,61.0,1,106.1,3,1,1,5
17792.0,0.0,2,370.05,4,1,2,7
17793.0,0.0,1,323.04,4,1,1,6
17794.0,0.0,2,147.3,4,1,1,6
17795.0,0.0,2,350.39,4,1,2,7
17796.0,101.0,7,1361.99,2,3,3,8
17797.0,66.0,8,1985.87,3,3,3,9
17798.0,524.0,1,183.09,1,1,1,3
17799.0,37.0,23,6216.74,3,4,4,11
17800.0,38.0,9,1199.01,3,4,3,10
17801.0,492.0,4,795.78,1,2,2,5
17802.0,5.0,16,4915.84,3,4,4,11
17803.0,365.0,1,184.66,2,1,1,4
17804.0,1063.0,4,380.13,1,2,2,5
17805.0,494.0,2,927.03,1,1,3,5
17806.0,0.0,1,546.04,4,1,2,7
17807.0,456.0,3,437.87,1,2,2,5
17808.0,461.0,4,262.64,1,2,1,4
17809.0,39.0,24,10498.85,3,4,4,11
17810.0,465.0,3,344.86,1,2,2,5
17811.0,2.0,60,9448.53,3,4,4,11
17812.0,334.0,7,1165.8899999999999,2,3,3,8
17813.0,184.0,7,1714.6,2,3,3,8
17814.0,0.0,2,1617.32,4,1,3,8
17815.0,395.0,1,591.96,1,1,2,4
17816.0,215.0,6,112.32,2,3,1,6
17817.0,160.0,7,801.15,2,3,2,7
17818.0,1032.0,1,130.18,1,1,1,3
17819.0,66.0,13,6568.719999999999,3,4,4,11
17820.0,339.0,3,159.51,2,2,1,5
17821.0,0.0,1,334.62,4,1,2,7
17822.0,0.0,5,2188.5,4,3,4,11
17823.0,0.0,2,494.25,4,1,2,7
17824.0,0.0,1,298.4,4,1,1,6
17825.0,0.0,4,731.96,4,2,2,8
17826.0,0.0,1,134.59,4,1,1,6
17827.0,37.0,7,2381.3,3,3,4,10
17828.0,127.0,9,1599.97,2,4,3,9
17829.0,396.0,6,4680.42,1,3,4,8
17830.0,121.0,3,398.7,2,2,2,6
17831.0,183.0,1,35.400000000000006,2,1,1,4
17832.0,0.0,1,155.37,4,1,1,6
17833.0,0.0,1,342.36,4,1,2,7
17834.0,0.0,2,730.47,4,1,2,7
17835.0,152.0,3,350.64,2,2,2,6
17836.0,0.0,1,110.21000000000001,4,1,1,6
17837.0,31.0,10,1560.53,3,4,3,10
17838.0,32.0,15,6239.55,3,4,4,11
17839.0,0.0,1,338.8,4,1,2,7
17840.0,0.0,1,185.72,4,1,1,6
17841.0,1.0,289,69516.19,3,4,4,11
17842.0,0.0,1,430.69,4,1,2,7
17843.0,100.0,2,326.23,3,1,2,6
17844.0,0.0,1,51.559999999999995,4,1,1,6
17845.0,371.0,4,598.19,1,2,2,5
17846.0,0.0,1,2033.1,4,1,3,8
17847.0,369.0,2,129.69,1,1,1,3
17848.0,251.0,31,3638.15,2,4,4,10
17849.0,71.0,8,1063.76,3,3,3,9
17850.0,70.0,159,55703.130000000005,3,4,4,11
17851.0,702.0,6,1563.34,1,3,3,7
17852.0,851.0,5,663.21,1,3,2,6
17853.0,1004.0,3,1608.19,1,2,3,6
17854.0,158.0,6,1071.45,2,3,3,8
17855.0,667.0,1,417.94,1,1,2,4
17856.0,121.0,6,1393.79,2,3,3,8
17857.0,33.0,26,28566.54,3,4,4,11
17858.0,3.0,32,12723.3,3,4,4,11
17859.0,131.0,1,148.21,2,1,1,4
17860.0,519.0,4,1015.54,1,2,3,6
17861.0,61.0,22,5064.59,3,4,4,11
17862.0,394.0,4,1279.09,1,2,3,6
17863.0,31.0,12,5745.2,3,4,4,11
17864.0,32.0,5,924.32,3,3,3,9
17865.0,2.0,62,25649.05,3,4,4,11
17866.0,368.0,4,1131.0,1,2,3,6
17867.0,91.0,20,895.78,3,4,3,10
17868.0,0.0,1,234.65,4,1,1,6
17869.0,128.0,7,1036.16,2,3,3,8
17870.0,93.0,14,3103.2,3,4,4,11
17871.0,432.0,5,1118.99,1,3,3,7
17872.0,0.0,1,235.87,4,1,1,6
17873.0,127.0,20,6229.56,2,4,4,10
17874.0,158.0,7,658.26,2,3,2,7
17875.0,0.0,1,167.1,4,1,1,6
17876.0,579.0,3,3424.02,1,2,4,7
17877.0,0.0,1,237.61,4,1,1,6
17878.0,456.0,3,1412.33,1,2,3,6
17879.0,0.0,1,178.51999999999998,4,1,1,6
17880.0,425.0,3,824.9200000000001,1,2,2,5
17881.0,131.0,1,133.35000000000002,2,1,1,4
17882.0,0.0,2,313.46,4,1,1,6
17883.0,159.0,8,979.95,2,3,3,8
17884.0,182.0,23,3028.89,2,4,4,10
17885.0,0.0,1,190.19,4,1,1,6
17886.0,122.0,7,1598.43,2,3,3,8
17887.0,305.0,1,111.35,2,1,1,4
17888.0,31.0,31,1318.9,3,4,3,10
17889.0,36.0,7,774.87,3,3,2,8
17890.0,0.0,2,602.09,4,1,2,7
17891.0,0.0,1,203.85999999999999,4,1,1,6
17892.0,157.0,3,244.1,2,2,1,5
17893.0,0.0,1,112.25,4,1,1,6
17894.0,246.0,20,2397.66,2,4,4,10
17895.0,0.0,1,98.0,4,1,1,6
17896.0,0.0,1,256.32,4,1,1,6
17897.0,371.0,10,2534.0,1,4,4,9
17898.0,0.0,4,299.18,4,2,1,7
17899.0,279.0,1,155.8,2,1,1,4
17900.0,308.0,4,15.0,2,2,1,5
17901.0,60.0,3,260.08,3,2,1,6
17902.0,400.0,1,216.39999999999998,1,1,1,3
17903.0,426.0,1,381.09000000000003,1,1,2,4
17904.0,0.0,2,178.92,4,1,1,6
17905.0,187.0,14,2374.22,2,4,4,10
17906.0,189.0,1,72.9,2,1,1,4
17907.0,464.0,1,291.76,1,1,1,3
17908.0,519.0,7,1357.89,1,3,3,7
17909.0,1032.0,1,132.55,1,1,1,3
17910.0,0.0,1,261.7,4,1,1,6
17911.0,0.0,1,366.23,4,1,2,7
17912.0,312.0,7,360.1,2,3,2,7
17913.0,1.0,14,3479.64,3,4,4,11
17914.0,182.0,1,336.43,2,1,2,5
17915.0,553.0,1,242.13,1,1,1,3
17916.0,912.0,2,43.87,1,1,1,3
17917.0,364.0,3,341.28,2,2,2,6
17918.0,0.0,3,396.39,4,2,2,8
17919.0,2.0,2,1840.32,3,1,3,7
17920.0,183.0,56,24509.91,2,4,4,10
17921.0,183.0,12,2383.35,2,4,4,10
17922.0,0.0,1,170.4,4,1,1,6
17923.0,311.0,3,497.0,2,2,2,6
17924.0,39.0,14,3445.28,3,4,4,11
17925.0,667.0,1,488.16,1,1,2,4
17926.0,462.0,5,1035.49,1,3,3,7
17927.0,0.0,1,294.0,4,1,1,6
17928.0,159.0,3,341.24,2,2,2,6
17929.0,253.0,13,3073.6,2,4,4,10
17930.0,184.0,15,4242.92,2,4,4,10
17931.0,518.0,18,3305.96,1,4,4,9
17932.0,6.0,3,1331.57,3,2,3,8
17933.0,0.0,1,114.69,4,1,1,6
17934.0,1.0,3,1049.15,3,2,3,8
17935.0,609.0,8,655.54,1,3,2,6
17936.0,243.0,1,389.84,2,1,2,5
17937.0,122.0,7,4301.22,2,3,4,9
17938.0,0.0,1,144.29,4,1,1,6
17939.0,279.0,1,99.14,2,1,1,4
17940.0,70.0,22,26960.02,3,4,4,11
17941.0,337.0,4,1433.28,2,2,3,7
17942.0,302.0,1,77.50000000000001,2,1,1,4
17943.0,0.0,1,-165.03,4,1,1,6
17944.0,366.0,1,75.41,1,1,1,3
17945.0,375.0,3,360.35,1,2,2,5
17946.0,0.0,2,149.57999999999998,4,1,1,6
17947.0,303.0,1,176.68,2,1,1,4
17948.0,0.0,1,358.56000000000006,4,1,2,7
17949.0,4.0,138,98895.59,3,4,4,11
17950.0,369.0,8,1412.65,1,3,3,7
17951.0,698.0,5,1618.38,1,3,3,7
17952.0,0.0,4,819.61,4,2,2,8
17953.0,0.0,1,160.82,4,1,1,6
17954.0,125.0,26,3831.56,2,4,4,10
17955.0,220.0,6,949.9,2,3,3,8
17956.0,251.0,1,12.75,2,1,1,4
17957.0,245.0,1,111.68,2,1,1,4
17958.0,759.0,2,973.88,1,1,3,5
17959.0,0.0,1,140.75,4,1,1,6
17960.0,495.0,3,135.08,1,2,1,4
17961.0,2.0,102,2979.09,3,4,4,11
17962.0,492.0,5,673.02,1,3,2,6
17963.0,400.0,4,651.51,1,2,2,5
17964.0,122.0,2,733.46,2,1,2,5
17965.0,10.0,33,7117.78,3,4,4,11
17966.0,34.0,10,1974.42,3,4,3,10
17967.0,639.0,2,357.28999999999996,1,1,2,4
17968.0,698.0,4,888.04,1,2,3,6
17969.0,369.0,27,2251.19,1,4,4,9
17970.0,5.0,1,582.59,3,1,2,6
17971.0,461.0,1,161.94,1,1,1,3
17972.0,7.0,1,136.04,3,1,1,5
17973.0,0.0,1,337.04,4,1,2,7
17974.0,250.0,6,1858.06,2,3,3,8
17975.0,154.0,26,6927.68,2,4,4,10
17976.0,667.0,1,706.38,1,1,2,4
17977.0,61.0,3,1507.73,3,2,3,8
17978.0,405.0,4,1461.76,1,2,3,6
17979.0,244.0,5,737.81,2,3,2,7
17980.0,395.0,4,1033.42,1,2,3,6
17981.0,0.0,1,239.12,4,1,1,6
17982.0,0.0,1,138.18,4,1,1,6
17983.0,456.0,1,171.71,1,1,1,3
17984.0,365.0,5,1191.27,2,3,3,8
17985.0,0.0,1,634.95,4,1,2,7
17986.0,0.0,1,20.8,4,1,1,6
17987.0,158.0,6,928.12,2,3,3,8
17988.0,338.0,15,479.59,2,4,2,8
17989.0,0.0,1,228.82999999999998,4,1,1,6
17990.0,460.0,7,1522.5700000000002,1,3,3,7
17991.0,0.0,3,320.55,4,2,1,7
17992.0,0.0,1,254.13,4,1,1,6
17993.0,706.0,1,235.19,1,1,1,3
17994.0,38.0,14,2262.87,3,4,4,11
17995.0,283.0,3,495.48,2,2,2,6
17996.0,400.0,3,482.33,1,2,2,5
17997.0,65.0,12,1511.3,3,4,3,10
17998.0,1032.0,4,601.74,1,2,2,5
17999.0,303.0,3,730.9,2,2,2,6
18000.0,0.0,1,124.25,4,1,1,6
18001.0,400.0,6,953.84,1,3,3,7
18002.0,672.0,4,249.92,1,2,1,4
18003.0,0.0,1,358.61,4,1,2,7
18004.0,364.0,1,169.47,2,1,1,4
18005.0,182.0,2,249.72,2,1,1,4
18006.0,705.0,4,997.86,1,2,3,6
18007.0,365.0,1,220.32,2,1,1,4
18008.0,37.0,23,19787.13,3,4,4,11
18009.0,554.0,14,2077.08,1,4,3,8
18010.0,0.0,1,174.8,4,1,1,6
18011.0,697.0,2,527.03,1,1,2,4
18012.0,0.0,1,115.3,4,1,1,6
18013.0,157.0,2,187.29,2,1,1,4
18014.0,30.0,1,166.42,3,1,1,5
18015.0,213.0,1,120.03,2,1,1,4
18016.0,153.0,7,1960.46,2,3,3,8
18017.0,312.0,4,688.0,2,2,2,6
18018.0,579.0,5,156.69,1,3,1,5
18019.0,0.0,1,38.45,4,1,1,6
18020.0,0.0,2,129.28,4,1,1,6
18021.0,0.0,2,227.06,4,1,1,6
18022.0,244.0,5,1651.79,2,3,3,8
18023.0,0.0,1,-3248.86,4,1,1,6
18024.0,65.0,3,236.77999999999997,3,2,1,6
18025.0,365.0,6,1177.72,2,3,3,8
18026.0,0.0,2,2074.07,4,1,3,8
18027.0,305.0,1,115.31,2,1,1,4
18028.0,585.0,1,192.05,1,1,1,3
18029.0,526.0,1,433.77,1,1,2,4
18030.0,213.0,3,220.7,2,2,1,5
18031.0,0.0,1,462.09999999999997,4,1,2,7
18032.0,101.0,1,73.5,2,1,1,4
18033.0,214.0,1,97.97,2,1,1,4
18034.0,0.0,3,793.7,4,2,2,8
18035.0,244.0,5,1276.74,2,3,3,8
18036.0,129.0,11,1563.6399999999999,2,4,3,9
18037.0,126.0,15,167.42,2,4,1,7
18038.0,704.0,1,149.41,1,1,1,3
18039.0,464.0,4,579.17,1,2,2,5
18040.0,129.0,2,357.20000000000005,2,1,2,5
18041.0,67.0,40,8669.65,3,4,4,11
18042.0,0.0,2,281.15,4,1,1,6
18043.0,486.0,3,875.97,1,2,3,6
18044.0,213.0,19,3502.66,2,4,4,10
18045.0,0.0,1,189.4,4,1,1,6
18046.0,0.0,1,189.63,4,1,1,6
18047.0,0.0,2,342.69,4,1,2,7
18048.0,643.0,3,401.73,1,2,2,5
18049.0,0.0,2,556.52,4,1,2,7
18050.0,395.0,2,412.06,1,1,2,4
18051.0,527.0,8,2275.98,1,3,4,8
18052.0,0.0,1,10877.18,4,1,4,9
18053.0,244.0,6,527.77,2,3,2,7
18054.0,365.0,1,176.5,2,1,1,4
18055.0,278.0,15,11163.52,2,4,4,10
18056.0,0.0,3,539.75,4,2,2,8
18057.0,395.0,3,1203.56,1,2,3,6
18058.0,435.0,3,774.06,1,2,2,5
18059.0,276.0,4,296.71,2,2,1,5
18060.0,0.0,2,1185.46,4,1,3,8
18061.0,34.0,29,6480.47,3,4,4,11
18062.0,193.0,9,1523.3700000000001,2,4,3,9
18063.0,0.0,2,186.60000000000002,4,1,1,6
18064.0,434.0,15,4441.18,1,4,4,9
18065.0,96.0,32,5836.88,3,4,4,11
18066.0,0.0,3,1440.4,4,2,3,9
18067.0,0.0,1,396.33,4,1,2,7
18068.0,0.0,1,101.69999999999999,4,1,1,6
18069.0,2.0,13,4525.71,3,4,4,11
18070.0,496.0,2,307.75,1,1,1,3
18071.0,455.0,6,1428.63,1,3,3,7
18072.0,156.0,2,-5.329070518200751e-15,2,1,1,4
18073.0,157.0,13,3864.44,2,4,4,10
18074.0,698.0,2,1509.04,1,1,3,5
18075.0,31.0,31,5579.91,3,4,4,11
18076.0,0.0,1,151.49,4,1,1,6
18077.0,33.0,18,4338.56,3,4,4,11
18078.0,189.0,4,844.6,2,2,3,7
18079.0,217.0,5,4242.75,2,3,4,9
18080.0,37.0,2,1231.5,3,1,3,7
18081.0,275.0,3,343.45,2,2,2,6
18082.0,0.0,1,703.37,4,1,2,7
18083.0,518.0,1,470.72999999999996,1,1,2,4
18084.0,39.0,5,193.72999999999996,3,3,1,7
18085.0,394.0,4,1645.75,1,2,3,6
18086.0,69.0,1,101.34,3,1,1,5
18087.0,39.0,21,14411.619999999999,3,4,4,11
18088.0,92.0,1,167.67000000000002,3,1,1,5
18089.0,0.0,1,428.45,4,1,2,7
18090.0,0.0,1,349.4,4,1,2,7
18091.0,0.0,1,360.85,4,1,2,7
18092.0,3.0,20,16173.19,3,4,4,11
18093.0,33.0,9,4429.61,3,4,4,11
18094.0,220.0,15,6322.62,2,4,4,10
18095.0,40.0,5,2303.09,3,3,4,10
18096.0,154.0,6,1805.28,2,3,3,8
18097.0,217.0,14,4652.17,2,4,4,10
18098.0,487.0,1,550.84,1,1,2,4
18099.0,247.0,1,168.31,2,1,1,4
18100.0,523.0,1,451.56,1,1,2,4
18101.0,649.0,5,629.16,1,3,2,6
18102.0,90.0,153,598215.22,3,4,4,11
18103.0,492.0,1,105.8,1,1,1,3
18104.0,303.0,1,754.64,2,1,2,5
18105.0,303.0,1,113.48000000000002,2,1,1,4
18106.0,0.0,6,1461.46,4,3,3,10
18107.0,0.0,1,167.13,4,1,1,6
18108.0,221.0,4,842.46,2,2,2,6
18109.0,5.0,45,9754.66,3,4,4,11
18110.0,0.0,3,405.18,4,2,2,8
18111.0,585.0,2,398.9,1,1,2,4
18112.0,553.0,4,775.96,1,2,2,5
18113.0,547.0,1,152.64000000000001,1,1,1,3
18114.0,0.0,1,220.1,4,1,1,6
18115.0,405.0,1,9.700000000000001,1,1,1,3
18116.0,276.0,13,2154.3,2,4,3,9
18117.0,0.0,1,320.72,4,1,1,6
18118.0,30.0,35,6670.07,3,4,4,11
18119.0,517.0,1,362.24,1,1,2,4
18120.0,97.0,1,111.15,3,1,1,5
18121.0,126.0,2,673.1,2,1,2,5
18122.0,4.0,6,1826.21,3,3,3,9
18123.0,122.0,3,684.59,2,2,2,6
18124.0,0.0,1,111.53,4,1,1,6
18125.0,61.0,5,1141.34,3,3,3,9
18126.0,62.0,1,206.82999999999998,3,1,1,5
18127.0,699.0,4,561.53,1,2,2,5
18128.0,0.0,1,420.04,4,1,2,7
18129.0,68.0,1,112.55000000000001,3,1,1,5
18130.0,30.0,4,1045.74,3,2,3,8
18131.0,0.0,1,222.95999999999998,4,1,1,6
18132.0,0.0,1,226.9,4,1,1,6
18133.0,6.0,2,715.4999999999999,3,1,2,6
18134.0,0.0,2,445.0,4,1,2,7
18135.0,60.0,13,1229.22,3,4,3,10
18136.0,6.0,9,1531.71,3,4,3,10
18137.0,553.0,2,145.99,1,1,1,3
18138.0,0.0,1,152.65,4,1,1,6
18139.0,0.0,8,8393.22,4,3,4,11
18140.0,0.0,1,536.41,4,1,2,7
18141.0,394.0,4,838.57,1,2,2,5
18142.0,5.0,4,1014.9,3,2,3,8
18143.0,0.0,2,1000.16,4,1,3,8
18144.0,36.0,19,5058.0,3,4,4,11
18145.0,398.0,12,5600.09,1,4,4,9
18146.0,281.0,2,160.35000000000002,2,1,1,4
18147.0,0.0,2,179.33999999999997,4,1,1,6
18148.0,648.0,1,114.10000000000001,1,1,1,3
18149.0,38.0,7,1624.71,3,3,3,9
18150.0,153.0,3,566.58,2,2,2,6
18151.0,617.0,7,1853.94,1,3,3,7
18152.0,648.0,1,426.69,1,1,2,4
18153.0,0.0,1,246.22,4,1,1,6
18154.0,182.0,5,932.6,2,3,3,8
18155.0,0.0,4,347.82,4,2,2,8
18156.0,578.0,2,941.1700000000001,1,1,3,5
18157.0,0.0,1,215.35,4,1,1,6
18158.0,2.0,3,451.75,3,2,2,7
18159.0,39.0,1,530.15,3,1,2,6
18160.0,0.0,3,1003.88,4,2,3,9
18161.0,184.0,7,1797.2,2,3,3,8
18162.0,882.0,1,379.16,1,1,2,4
18163.0,615.0,2,639.34,1,1,2,4
18164.0,121.0,2,394.7,2,1,2,5
18165.0,0.0,1,302.46000000000004,4,1,1,6
18166.0,0.0,1,175.5,4,1,1,6
18167.0,93.0,6,1355.51,3,3,3,9
18168.0,70.0,22,3670.12,3,4,4,11
18169.0,62.0,1,202.65,3,1,1,5
18170.0,183.0,9,2878.0,2,4,4,10
18171.0,1.0,11,2414.51,3,4,4,11
18172.0,5.0,63,17301.83,3,4,4,11
18173.0,69.0,5,2696.36,3,3,4,10
18174.0,302.0,2,162.5,2,1,1,4
18175.0,677.0,1,176.1,1,1,1,3
18176.0,0.0,2,448.65,4,1,2,7
18177.0,122.0,10,2189.62,2,4,4,10
18178.0,250.0,15,6054.49,2,4,4,10
18179.0,163.0,8,2547.55,2,3,4,9
18180.0,2.0,6,1843.75,3,3,3,9
18181.0,609.0,7,1184.21,1,3,3,7
18182.0,670.0,1,291.13,1,1,1,3
18183.0,69.0,6,600.52,3,3,2,8
18184.0,0.0,1,49.8,4,1,1,6
18185.0,251.0,1,304.25,2,1,1,4
18186.0,0.0,1,329.58,4,1,2,7
18187.0,0.0,3,682.19,4,2,2,8
18188.0,580.0,8,3263.19,1,3,4,8
18189.0,0.0,5,1396.58,4,3,3,10
18190.0,0.0,6,735.6700000000001,4,3,2,9
18191.0,0.0,2,529.4,4,1,2,7
18192.0,0.0,1,957.97,4,1,3,8
18193.0,4.0,5,1155.7,3,3,3,9
18194.0,183.0,7,4084.2000000000003,2,3,4,9
18195.0,0.0,1,101.16,4,1,1,6
18196.0,216.0,4,1464.31,2,2,3,7
18197.0,0.0,2,221.4,4,1,1,6
18198.0,122.0,21,5083.06,2,4,4,10
18199.0,677.0,2,342.2,1,1,2,4
18200.0,0.0,1,163.8,4,1,1,6
18201.0,0.0,1,447.53000000000003,4,1,2,7
18202.0,343.0,3,1396.99,2,2,3,7
18203.0,218.0,4,504.42,2,2,2,6
18204.0,0.0,4,1979.3,4,2,3,9
18205.0,275.0,2,517.36,2,1,2,5
18206.0,614.0,1,314.65999999999997,1,1,1,3
18207.0,643.0,3,505.12,1,2,2,5
18208.0,0.0,1,360.08,4,1,2,7
18209.0,30.0,1,139.10000000000002,3,1,1,5
18210.0,61.0,7,2768.83,3,3,4,10
18211.0,191.0,5,600.07,2,3,2,7
18212.0,0.0,2,546.72,4,1,2,7
18213.0,0.0,1,232.48000000000002,4,1,1,6
18214.0,491.0,5,1480.99,1,3,3,7
18215.0,32.0,6,2238.9900000000002,3,3,4,10
18216.0,122.0,1,481.75,2,1,2,5
18217.0,61.0,6,902.8,3,3,3,9
18218.0,6.0,6,1106.3,3,3,3,9
18219.0,97.0,19,3507.39,3,4,4,11
18220.0,250.0,11,1771.7,2,4,3,9
18221.0,6.0,8,1370.34,3,3,3,9
18222.0,124.0,1,443.0,2,1,2,5
18223.0,2.0,52,13497.58,3,4,4,11
18224.0,0.0,1,158.95000000000002,4,1,1,6
18225.0,162.0,34,12650.91,2,4,4,10
18226.0,10.0,38,11748.58,3,4,4,11
18227.0,189.0,3,93.75,2,2,1,5
18228.0,0.0,3,769.2,4,2,2,8
18229.0,1.0,28,10803.710000000001,3,4,4,11
18230.0,61.0,12,4190.71,3,4,4,11
18231.0,371.0,30,6848.17,1,4,4,9
18232.0,218.0,5,582.47,2,3,2,7
18233.0,0.0,1,440.0,4,1,2,7
18234.0,553.0,1,179.6,1,1,1,3
18235.0,33.0,3,1796.48,3,2,3,8
18236.0,61.0,12,1795.3500000000001,3,4,3,10
18237.0,3.0,5,987.1,3,3,3,9
18238.0,369.0,1,270.92,1,1,1,3
18239.0,220.0,6,2150.36,2,3,3,8
18240.0,0.0,1,422.58,4,1,2,7
18241.0,31.0,23,2954.09,3,4,4,11
18242.0,67.0,8,3605.21,3,3,4,10
18243.0,0.0,1,515.78,4,1,2,7
18244.0,580.0,2,568.64,1,1,2,4
18245.0,6.0,23,6236.2300000000005,3,4,4,11
18246.0,463.0,3,758.8199999999999,1,2,2,5
18247.0,492.0,6,721.43,1,3,2,6
18248.0,94.0,4,783.02,3,2,2,7
18249.0,0.0,1,95.34,4,1,1,6
18250.0,39.0,2,342.92,3,1,2,6
18251.0,403.0,9,26278.86,1,4,4,9
18252.0,405.0,8,1465.59,1,3,3,7
18253.0,526.0,1,317.88,1,1,1,3
18254.0,524.0,1,267.9,1,1,1,3
18255.0,32.0,2,303.15,3,1,1,5
18256.0,0.0,2,60.599999999999994,4,1,1,6
18257.0,161.0,18,4496.8,2,4,4,10
18258.0,400.0,8,2040.97,1,3,3,7
18259.0,486.0,7,4318.200000000001,1,3,4,8
18260.0,101.0,32,9751.95,2,4,4,10
18261.0,216.0,2,324.24,2,1,1,4
18262.0,395.0,3,577.54,1,2,2,5
18263.0,157.0,4,1211.08,2,2,3,7
18264.0,0.0,1,603.25,4,1,2,7
18265.0,248.0,2,801.51,2,1,2,5
18266.0,700.0,1,251.1,1,1,1,3
18267.0,588.0,2,252.87,1,1,1,3
18268.0,465.0,8,1451.22,1,3,3,7
18269.0,486.0,2,307.5,1,1,1,3
18270.0,334.0,4,400.35,2,2,2,6
18271.0,463.0,2,680.85,1,1,2,4
18272.0,4.0,11,4347.33,3,4,4,11
18273.0,152.0,4,357.0,2,2,2,6
18274.0,91.0,2,1.7763568394002505e-15,3,1,1,5
18275.0,432.0,2,741.85,1,1,2,4
18276.0,365.0,10,1620.67,2,4,3,9
18277.0,1.0,8,1111.38,3,3,3,9
18278.0,0.0,2,414.20000000000005,4,1,2,7
18279.0,491.0,1,231.33999999999997,1,1,1,3
18280.0,161.0,3,472.45000000000005,2,2,2,6
18281.0,5.0,2,201.14,3,1,1,5
18282.0,94.0,3,176.6,3,2,1,6
18283.0,61.0,22,2736.65,3,4,4,11
18284.0,549.0,2,436.68,1,1,2,4
18285.0,0.0,1,427.0,4,1,2,7
18286.0,0.0,3,1188.43,4,2,3,9
18287.0,1.0,8,4177.89,3,3,4,10
